sld,occurrence_count,words,word_count,length,vowels,consonants,vowel_percentage
telecomitalia,59820079,"['telecom', 'italia']",2,13,7,6,53.85
googleusercontent,41394496,"['google', 'user', 'content']",3,17,7,10,41.18
barracudanetworks,26817069,"['barracuda', 'networks']",2,17,6,11,35.29
akamaitechnologies,23751429,"['kama', 'technologies']",2,18,9,9,50.0
clearwebstats,22100454,"['clear', 'web', 'stats']",3,13,4,9,30.77
btcentralplus,21661150,"['central', 'plus']",2,13,3,10,23.08
cloudflaressl,16673286,"['cloud', 'flare', 'ssl']",3,13,4,9,30.77
zendesk-staging,12581896,"['zen', 'desk', 'staging']",3,15,4,11,26.67
affiliatblogger,4744344,"['ili', 'blogger']",2,15,6,9,40.0
cloudflarestorage,3546104,"['cloud', 'flare', 'storage']",3,17,7,10,41.18
helpscoutdocs,3313754,"['help', 'scout', 'docs']",3,13,4,9,30.77
kabel-deutschland,3065271,"['abel', 'deutschland']",2,17,5,12,29.41
elisa-laajakaista,2923701,"['elisa', 'aja', 'kaist']",3,17,9,8,52.94
anyscale-test,2890496,"['any', 'scale', 'test']",3,13,4,9,30.77
absorbtraining,2514163,"['absorb', 'training']",2,14,5,9,35.71
ewe-ip-backbone,2333953,"['ewe', 'backbone']",2,15,6,9,40.0
insanejournal,2333097,"['insane', 'journal']",2,13,6,7,46.15
blogs-service,2273052,"['blogs', 'service']",2,13,4,9,30.77
designertoblog,2170695,"['designer', 'blog']",2,14,5,9,35.71
linodeusercontent,2165422,"['node', 'user', 'content']",3,17,7,10,41.18
vultrusercontent,2140571,"['vult', 'user', 'content']",3,16,5,11,31.25
interbusiness,2112098,"['inter', 'business']",2,13,5,8,38.46
omisenomikata,2045545,"['omi', 'sen', 'omi', 'kata']",4,13,7,6,53.85
play-internet,1843204,"['play', 'internet']",2,13,4,9,30.77
strikinglydns,1720358,"['strikingly', 'dns']",2,13,2,11,15.38
goodversusevil,1688078,"['good', 'versus', 'evil']",3,14,6,8,42.86
whomadeyoumirabelli,1642591,"['who', 'made', 'you', 'mirabel']",4,19,9,10,47.37
indiebloggers,1537879,"['indie', 'bloggers']",2,13,5,8,38.46
commanderselvam,1473101,"['commanders', 'elva']",2,15,5,10,33.33
universitytutor,1440590,"['university', 'tutor']",2,15,6,9,40.0
superiorjuegos,1368148,"['superior', 'juegos']",2,14,7,7,50.0
ziggozakelijk,1336073,"['zig', 'zak', 'eli']",3,13,5,8,38.46
bootcampbeijing,1289576,"['boot', 'camp', 'beijing']",3,15,6,9,40.0
morgellonssupport,1281508,"['orgel', 'lons', 'support']",3,17,5,12,29.41
websiteoutlook,1244092,"['website', 'outlook']",2,14,7,7,50.0
nationalcablenetworks,1243241,"['national', 'cable', 'networks']",3,21,8,13,38.1
dontkillmyapp,1218540,"['dont', 'kill', 'app']",3,13,3,10,23.08
brasembancara,1190039,"['bras', 'ban', 'cara']",3,13,5,8,38.46
grandenetworks,1171268,"['grande', 'networks']",2,14,4,10,28.57
insidehollywoodfilms,1163460,"['inside', 'hollywood', 'films']",3,20,7,13,35.0
downloadastro,1073250,"['download', 'astro']",2,13,5,8,38.46
reverse-mundo-r,1057883,"['reverse', 'mundo']",2,15,5,10,33.33
intercom-mail,1034733,"['intercom', 'mail']",2,13,5,8,38.46
webstatsdomain,1025040,"['web', 'stats', 'domain']",3,14,5,9,35.71
vistaprintdigital,988242,"['vista', 'print', 'digital']",3,17,6,11,35.29
rightmatching,936801,"['right', 'matching']",2,13,3,10,23.08
concursonacionalalianza,928582,"['concur', 'nacional', 'alianza']",3,23,11,12,47.83
happyvalentinesdays,926939,"['happy', 'valentines', 'days']",3,19,6,13,31.58
theenglishfaculty,909654,"['the', 'english', 'faculty']",3,17,5,12,29.41
huaweicdn-vip,899850,"['hua', 'icd', 'vip']",3,13,5,8,38.46
inclineincubator,886318,"['incline', 'incubator']",2,16,7,9,43.75
americanamusicacademy,826561,"['american', 'music', 'academy']",3,21,10,11,47.62
bigrockservers,808018,"['big', 'rock', 'servers']",3,14,4,10,28.57
beijingyourway,802840,"['beijing', 'your', 'way']",3,14,6,8,42.86
bluestreamfiber,793665,"['blue', 'stream', 'fiber']",3,15,6,9,40.0
theothersideofaids,767811,"['the', 'other', 'side', 'aids']",4,18,8,10,44.44
ceipsangabrielalmeriaandalucia,757650,"['ips', 'gabriel', 'almeria', 'and', 'lucia']",5,30,15,15,50.0
reserve-online,754231,"['reserve', 'online']",2,14,6,8,42.86
sustainable-learning,750392,"['sustainable', 'learning']",2,20,8,12,40.0
bouyguestelecom,747133,"['bouy', 'gue', 'telecom']",3,15,7,8,46.67
onecommunications,743547,"['one', 'communications']",2,17,8,9,47.06
clearlove-sjdiofio-qiui,731262,"['clear', 'love']",2,23,11,12,47.83
linn-ky-hth-333,728877,"['linn', '333']",2,15,1,14,6.67
getambassador,724092,"['get', 'ambassador']",2,13,5,8,38.46
online-rewards,721800,"['online', 'rewards']",2,14,5,9,35.71
platformdxc-mg,719802,"['platform', 'dxc']",2,14,2,12,14.29
sadecehosting,708545,"['sad', 'ece', 'hosting']",3,13,5,8,38.46
eyecatchythemes,695658,"['eye', 'catchy', 'themes']",3,15,5,10,33.33
dedicatedornot,653001,"['dedicated', 'not']",2,14,6,8,42.86
sharewarejunction,626872,"['shareware', 'junction']",2,17,7,10,41.18
stadtbranchenbuch,623986,"['stadt', 'branch', 'buch']",3,17,4,13,23.53
livederby2007,621870,"['live', 'derby', '2007']",3,13,3,10,23.08
analyticapproach,617800,"['analytic', 'approach']",2,16,6,10,37.5
awsglobalaccelerator,600972,"['global', 'accelerator']",2,20,8,12,40.0
websiteprofile,567068,"['website', 'profile']",2,14,6,8,42.86
rockfallsfiber,559643,"['rock', 'falls', 'fiber']",3,14,4,10,28.57
filemaker-cloud,556692,"['file', 'maker', 'cloud']",3,15,6,9,40.0
pissedconsumer,555729,"['pissed', 'consumer']",2,14,5,9,35.71
acuityscheduling,546489,"['acuity', 'scheduling']",2,16,6,10,37.5
azurewebsites,533103,"['azure', 'websites']",2,13,6,7,46.15
wpenginepowered,503605,"['engine', 'powered']",2,15,6,9,40.0
hllyelectronics,486981,['electronics'],1,15,4,11,26.67
foreclosureconnections,486570,"['foreclosure', 'connections']",2,22,9,13,40.91
apogeeetelecom,478954,"['apogee', 'telecom']",2,14,8,6,57.14
unbouncepages,476684,"['bounce', 'pages']",2,13,6,7,46.15
cocolog-nifty,461817,"['coco', 'log', 'nifty']",3,13,4,9,30.77
churchcenteronline,454329,"['church', 'center', 'online']",3,18,6,12,33.33
acedatacenter,447789,"['ace', 'datacenter']",2,13,6,7,46.15
blogprodesign,432423,"['blog', 'pro', 'design']",3,13,4,9,30.77
articlesblogger,431502,"['articles', 'blogger']",2,15,5,10,33.33
educationalimpactblog,426054,"['educational', 'impact', 'blog']",3,21,9,12,42.86
hostgatorwebservers,422919,"['host', 'gator', 'web', 'servers']",4,19,6,13,31.58
adamkhoowealth,415264,"['adam', 'khoo', 'wealth']",3,14,6,8,42.86
fusionbroadband,411754,"['fusion', 'broadband']",2,15,6,9,40.0
mybloglicious,404832,"['blog', 'licious']",2,13,5,8,38.46
review-blogger,404088,"['review', 'blogger']",2,14,5,9,35.71
prioritytelecom,403754,"['priority', 'telecom']",2,15,6,9,40.0
summer-difd-idio,389115,"['summer', 'dio']",2,16,6,10,37.5
trafficmanager,388406,"['traffic', 'manager']",2,14,5,9,35.71
capitalfarmer,387084,"['capital', 'farmer']",2,13,5,8,38.46
elasticbeanstalk,384268,"['elastic', 'beanstalk']",2,16,6,10,37.5
coachoutletstoreonlinesite,380292,"['coach', 'outlet', 'store', 'online', 'site']",5,26,12,14,46.15
freefunnyvideo,379656,"['free', 'funny', 'video']",3,14,6,8,42.86
luxurycapezane,376425,"['luxury', 'cape', 'zane']",3,14,6,8,42.86
carrier2carrier,375545,"['carrier', 'carrier']",2,15,6,9,40.0
janiceelliott,373377,"['janice', 'elliott']",2,13,6,7,46.15
greenwichredcross,370343,"['greenwich', 'red', 'cross']",3,17,5,12,29.41
stackexchange,369763,"['stack', 'exchange']",2,13,4,9,30.77
bulletproofhosting,359821,"['bulletproof', 'hosting']",2,18,6,12,33.33
nec-enterprise,359303,"['nec', 'enterprise']",2,14,5,9,35.71
packetexchange,353481,"['packet', 'exchange']",2,14,5,9,35.71
massagetherapy,353254,"['massage', 'therapy']",2,14,5,9,35.71
cedricjensene,351603,"['cedric', 'jensen']",2,13,5,8,38.46
livejasmintease,343004,"['live', 'jasmin', 'tease']",3,15,7,8,46.67
sattamassagana,342585,"['tamas', 'sagan']",2,14,6,8,42.86
weixinfoundation,341843,['foundation'],1,16,8,8,50.0
182-airtelbroadband,335634,"['182', 'airtel', 'broadband']",3,19,6,13,31.58
stspg-customer,332033,"['spg', 'customer']",2,14,3,11,21.43
satcom-systems,326354,"['com', 'systems']",2,14,3,11,21.43
122-airtelbroadband,320734,"['122', 'airtel', 'broadband']",3,19,6,13,31.58
theamericansheeple,319175,"['the', 'american', 'sheep']",3,18,8,10,44.44
obsidianportal,315630,"['obsidian', 'portal']",2,14,6,8,42.86
james-robertson,304761,"['james', 'robertson']",2,15,5,10,33.33
jerseyscheap4you,300928,"['jerseys', 'cheap', 'you']",3,16,6,10,37.5
kansashealthsystem,300324,"['kansas', 'health', 'system']",3,18,5,13,27.78
anisacatering,294912,['catering'],1,13,6,7,46.15
contaboserver,290954,"['cont', 'abo', 'server']",3,13,5,8,38.46
orangecustomers,288261,"['orange', 'customers']",2,15,6,9,40.0
mynewblogsite,284366,"['new', 'blog', 'site']",3,13,4,9,30.77
mydevryportfolio,284076,"['vry', 'portfolio']",2,16,5,11,31.25
leaguerepublic,279790,"['league', 'republic']",2,14,7,7,50.0
travellerspoint,276786,"['travellers', 'point']",2,15,5,10,33.33
findlandscapecontractors,272155,"['find', 'landscape', 'contractors']",3,24,7,17,29.17
orangearmenia,267836,"['orange', 'armenia']",2,13,7,6,53.85
mightynetworks,262228,"['mighty', 'networks']",2,14,3,11,21.43
alternativeto,260320,['alternative'],1,13,6,7,46.15
allegrimonelli-edu,255102,"['allegri', 'one', 'lli', 'edu']",4,18,8,10,44.44
foreclosurewarehouse,253251,"['foreclosure', 'warehouse']",2,20,10,10,50.0
000webhostapp,251974,"['000', 'web', 'host', 'app']",4,13,3,10,23.08
thrivedeskdocs,251262,"['thrive', 'desk', 'docs']",3,14,4,10,28.57
creative-servers,245368,"['creative', 'servers']",2,16,6,10,37.5
thextremenutrition,244335,"['the', 'xtreme', 'nutrition']",3,18,7,11,38.89
takamatsu-fivearrows,236063,"['takamatsu', 'five', 'arrows']",3,20,8,12,40.0
programas-gratis,235862,"['program', 'gratis']",2,16,5,11,31.25
kleinanzegien,235248,"['klein', 'anz', 'ien']",3,13,6,7,46.15
abandonedproperty,234505,"['abandoned', 'property']",2,17,6,11,35.29
pagesperso-orange,229903,"['pages', 'perso', 'orange']",3,17,7,10,41.18
poczta-online,229812,['online'],1,13,5,8,38.46
mystudenthosting,227602,"['student', 'hosting']",2,16,4,12,25.0
searchengineinfo,227249,"['search', 'engine', 'info']",3,16,7,9,43.75
thelyricarchive,226689,"['the', 'lyric', 'archive']",3,15,5,10,33.33
leaguetoolbox,221927,"['league', 'toolbox']",2,13,7,6,53.85
livefreepornvideo,216822,"['live', 'free', 'porn', 'video']",4,17,8,9,47.06
directideleteddomain,215930,"['direct', 'deleted', 'domain']",3,20,9,11,45.0
airstreamcomm,215783,"['air', 'stream', 'com']",3,13,5,8,38.46
buckminster076,212007,"['buckminster', '076']",2,14,3,11,21.43
hawaiiteleport,211293,"['hawaii', 'teleport']",2,14,7,7,50.0
thenetworkfactory,210842,"['the', 'network', 'factory']",3,17,5,12,29.41
mandyprofiles,208302,"['mandy', 'profiles']",2,13,4,9,30.77
teleport-iabg,197410,['teleport'],1,13,5,8,38.46
health-partners,196749,"['health', 'partners']",2,15,4,11,26.67
additionnetworks,196114,"['addition', 'networks']",2,16,6,10,37.5
myhealthychocolateblog,196058,"['healthy', 'chocolate', 'blog']",3,22,7,15,31.82
tailormadeservers,195369,"['tailor', 'made', 'servers']",3,17,7,10,41.18
uni-heidelberg,195315,"['uni', 'heidelberg']",2,14,6,8,42.86
gobrightspeed,194363,"['bright', 'speed']",2,13,4,9,30.77
mailprotector,192863,"['mail', 'protector']",2,13,5,8,38.46
oracleoutsourcing,192597,"['oracle', 'outsourcing']",2,17,8,9,47.06
telebecinternet,191064,"['tele', 'bec', 'internet']",3,15,6,9,40.0
samsungtabletpc,189978,"['samsung', 'tablet']",2,15,4,11,26.67
niketnrequinfr,189772,"['nike', 'quin']",2,14,5,9,35.71
signmyguestbook,189120,"['sign', 'guest', 'book']",3,15,5,10,33.33
webninjashops,188786,"['web', 'ninja', 'shops']",3,13,4,9,30.77
yangguangyanglao,188068,"['yang', 'guang', 'yang', 'lao']",4,16,6,10,37.5
opticaljungle,187890,"['optical', 'jungle']",2,13,5,8,38.46
softwareprimary,187188,"['software', 'primary']",2,15,5,10,33.33
naturalwireless,186160,"['natural', 'wireless']",2,15,6,9,40.0
remotewebaccess,185842,"['remote', 'web', 'access']",3,15,6,9,40.0
spearpointing,185677,"['spear', 'pointing']",2,13,5,8,38.46
naturalishealthy,184878,"['naturalis', 'healthy']",2,16,6,10,37.5
bradleycrossing,183889,"['bradley', 'crossing']",2,15,4,11,26.67
frontiernetworks,182434,"['frontier', 'networks']",2,16,5,11,31.25
xn--djrq84b3sfdwak93dz4q8qc,180066,[],0,27,1,26,3.7
huijieyoufawu,179405,"['hui', 'jie', 'you']",3,13,8,5,61.54
huangtianshiye,179313,"['huang', 'tian', 'shi']",3,14,6,8,42.86
footballworld,178591,"['football', 'world']",2,13,4,9,30.77
rogerstelecom,173470,"['rogers', 'telecom']",2,13,5,8,38.46
amazoncognito,172507,"['amazon', 'ogni']",2,13,6,7,46.15
medianet-world,171945,"['media', 'net', 'world']",3,14,5,9,35.71
inmotionhosting,171759,"['motion', 'hosting']",2,15,6,9,40.0
nordiceuropean,171711,"['nordic', 'european']",2,14,7,7,50.0
forcefieldapp,170798,"['force', 'field', 'app']",3,13,5,8,38.46
windhorseproject,170484,"['wind', 'horse', 'project']",3,16,5,11,31.25
deepdialogues,169409,"['deep', 'dialogues']",2,13,7,6,53.85
escortbabylon,168579,"['escort', 'babylon']",2,13,4,9,30.77
extractorvent,168071,"['extractor', 'vent']",2,13,4,9,30.77
worldsexplanet,165060,"['world', 'sex', 'planet']",3,14,4,10,28.57
defirmenkataloge,164382,"['firm', 'kata', 'loge']",3,16,7,9,43.75
dirtysexyprettyfun,163626,"['dirty', 'sexy', 'pretty', 'fun']",4,18,4,14,22.22
ezecastlehosting,162511,"['eze', 'castle', 'hosting']",3,16,6,10,37.5
lindaprofiles,161850,"['linda', 'profiles']",2,13,5,8,38.46
cloudbeds-dev,157498,"['cloud', 'beds', 'dev']",3,13,4,9,30.77
uni-stuttgart,157392,"['uni', 'stuttgart']",2,13,4,9,30.77
shoplightspeed,156228,"['shop', 'lightspeed']",2,14,4,10,28.57
patientrewardshub,154976,"['patient', 'rewards', 'hub']",3,17,6,11,35.29
dropboxusercontent,153433,"['drop', 'box', 'user', 'content']",4,18,6,12,33.33
residentportal,153094,"['resident', 'portal']",2,14,5,9,35.71
mammothnetworks,152954,"['mammoth', 'networks']",2,15,4,11,26.67
bluehostwebservers,151977,"['blue', 'host', 'web', 'servers']",4,18,6,12,33.33
hotsexyandbigtits,150804,"['hot', 'sexy', 'and', 'big', 'tits']",5,17,5,12,29.41
aviationmanagement,150562,"['aviation', 'management']",2,18,9,9,50.0
genericreverse,149367,"['generic', 'reverse']",2,14,6,8,42.86
top-hotels-gr,146703,"['top', 'hotels']",2,13,3,10,23.08
nationbuilder,146105,"['nation', 'builder']",2,13,6,7,46.15
free-press-release,142995,"['free', 'press', 'release']",3,18,7,11,38.89
123-free-download,142477,"['123', 'free', 'download']",3,17,5,12,29.41
webmatrixhosting,141170,"['web', 'matrix', 'hosting']",3,16,5,11,31.25
innovacion-gascaribe,141167,"['nova', 'gas', 'caribe']",3,20,9,11,45.0
enginetroublecode,140730,"['engine', 'trouble', 'code']",3,17,8,9,47.06
weddingdressestoday,138472,"['wedding', 'dresses', 'today']",3,19,6,13,31.58
allgenderhealth,138450,"['all', 'gender', 'health']",3,15,5,10,33.33
sandboxwordpress,136904,"['sandbox', 'wordpress']",2,16,4,12,25.0
staysecuregroup,136556,"['stay', 'secure', 'group']",3,15,6,9,40.0
digitaloceanspaces,136296,"['digital', 'ocean', 'spaces']",3,18,8,10,44.44
schooljotter2,135919,"['school', 'otter']",2,13,4,9,30.77
hotels-brazil,135569,"['hotels', 'brazil']",2,13,4,9,30.77
hammerwebsites,133833,"['hammer', 'websites']",2,14,5,9,35.71
hosted-by-vdsina,133179,['hosted'],1,16,4,12,25.0
rockstrailersales,132372,"['rocks', 'trailer', 'sales']",3,17,6,11,35.29
utc-fire-security,132044,"['utc', 'fire', 'security']",3,17,6,11,35.29
thebestlisting,131941,"['the', 'best', 'listing']",3,14,4,10,28.57
empresas-espana,130512,"['emp', 'res', 'espana']",3,15,6,9,40.0
minecraftturk,128914,"['minecraft', 'turk']",2,13,4,9,30.77
oss-marketplace,128898,"['oss', 'marketplace']",2,15,5,10,33.33
songlyricslibrary,127521,"['song', 'lyrics', 'library']",3,17,4,13,23.53
uni-greifswald,126930,"['uni', 'greifswald']",2,14,5,9,35.71
kennasecurity,126828,"['kenna', 'security']",2,13,5,8,38.46
pythonanywhere,126016,"['python', 'anywhere']",2,14,4,10,28.57
nudeglamourbabe,124146,"['nude', 'glamour', 'babe']",3,15,7,8,46.67
jewelershowcase,123917,"['jeweler', 'showcase']",2,15,6,9,40.0
uni-duisburg-essen,123210,"['uni', 'duisburg', 'essen']",3,18,7,11,38.89
broadbandscope,122910,"['broadband', 'scope']",2,14,5,9,35.71
camgirlrumors,121776,"['cam', 'girl', 'rumors']",3,13,4,9,30.77
dedicatedpanel,121654,"['dedicated', 'panel']",2,14,6,8,42.86
lightinthebox,119591,"['light', 'the', 'box']",3,13,4,9,30.77
volkssolidaritaet,119363,"['volks', 'solid', 'arita']",3,17,7,10,41.18
suzyq-records,119346,"['suzy', 'records']",2,13,3,10,23.08
mlmsuccessfactor,119049,"['success', 'factor']",2,16,4,12,25.0
hosted-by-worldstream,118507,"['hosted', 'world', 'stream']",3,21,5,16,23.81
startdedicated,118153,"['start', 'dedicated']",2,14,5,9,35.71
newcominternational,117825,"['new', 'com', 'international']",3,19,8,11,42.11
decodingplaces,117045,"['decoding', 'places']",2,14,5,9,35.71
ondigitalocean,116525,"['digital', 'ocean']",2,14,7,7,50.0
dongadfadftian,116518,"['dong', 'adf', 'adf', 'tian']",4,14,5,9,35.71
partnershipbroadband,115229,"['partnership', 'broadband']",2,20,6,14,30.0
kundencontroller,114910,"['nden', 'controller']",2,16,5,11,31.25
lordsrecoveryinthailand,114596,"['lords', 'recovery', 'thailand']",3,23,8,15,34.78
shoppsychicspectrum,114456,"['shop', 'psychic', 'spectrum']",3,19,4,15,21.05
agent-bord-030-if,114416,"['agent', 'bord', '030']",3,17,4,13,23.53
pmpl-broadband,113939,"['mpl', 'broadband']",2,14,3,11,21.43
highrevenuegate,112869,"['high', 'revenue', 'gate']",3,15,7,8,46.67
marketbitcoin,112568,"['market', 'bitcoin']",2,13,5,8,38.46
hotelsinflorida,111964,"['hotels', 'florida']",2,15,6,9,40.0
alltimesportscardsandgifts,111948,"['all', 'time', 'sports', 'cards', 'and', 'gifts']",6,26,7,19,26.92
made-in-china,109780,"['made', 'china']",2,13,5,8,38.46
uni-wuppertal,109080,"['uni', 'wuppertal']",2,13,5,8,38.46
hostingmerahputih,108956,"['hosting', 'rah', 'putih']",3,17,6,11,35.29
iplannetworks,108741,"['plan', 'networks']",2,13,4,9,30.77
senecadigital,107750,"['seneca', 'digital']",2,13,6,7,46.15
pamcleaningservices,107739,"['pam', 'cleaning', 'services']",3,19,7,12,36.84
potala-palace,107736,"['potala', 'palace']",2,13,6,7,46.15
freedownloadmp3,107137,"['free', 'download']",2,15,5,10,33.33
ezhostingserver,107033,"['hosting', 'server']",2,15,5,10,33.33
livecam-secrets,106944,"['live', 'cam', 'secrets']",3,15,5,10,33.33
myrealestateplatform,106759,"['real', 'estate', 'platform']",3,20,7,13,35.0
kaisa-laajakaista,105777,"['kais', 'aja', 'kaist']",3,17,9,8,52.94
findthebetter,105630,"['find', 'the', 'better']",3,13,4,9,30.77
toprevenuegate,103920,"['top', 'revenue', 'gate']",3,14,7,7,50.0
sl-laajakaista,103245,"['aja', 'kaist']",2,14,6,8,42.86
myblackporntube,103082,"['black', 'porn', 'tube']",3,15,4,11,26.67
uslocalfinder,102039,"['local', 'finder']",2,13,5,8,38.46
pegaenablement,101940,"['peg', 'enable', 'ment']",3,14,6,8,42.86
highcpmrevenuenetwork,101890,"['high', 'revenue', 'network']",3,21,7,14,33.33
telusmobility,101770,"['telus', 'mobility']",2,13,5,8,38.46
truckpromotions,101580,"['truck', 'promotions']",2,15,5,10,33.33
bookingexperts,101478,"['booking', 'experts']",2,14,5,9,35.71
ruhr-uni-bochum,101169,"['ruhr', 'uni', 'bochum']",3,15,5,10,33.33
securitysystemsdir,100200,"['security', 'systems', 'dir']",3,18,5,13,27.78
fwbsjnakjabdname,100083,"['nak', 'abd', 'name']",3,16,4,12,25.0
buildingcontractorsdirs,100072,"['building', 'contractors', 'dir']",3,23,7,16,30.43
createlastingsuccess,99069,"['create', 'lasting', 'success']",3,20,7,13,35.0
foretagsmagazinet,98988,"['fore', 'tags', 'magazine']",3,17,7,10,41.18
tributecenterstore,98501,"['tribute', 'center', 'store']",3,18,7,11,38.89
cyfrowypolsat,97846,"['fro', 'pols']",2,13,3,10,23.08
mikkeyhalsted,97841,"['mik', 'key', 'hals', 'ted']",4,13,4,9,30.77
instasexyblog,97522,"['insta', 'sexy', 'blog']",3,13,4,9,30.77
listen2myradio,97206,"['listen', 'radio']",2,14,5,9,35.71
serviciotecnicoeuropa,96520,"['ser', 'vici', 'otec', 'nico', 'europa']",5,21,11,10,52.38
rk-joomlawork,96180,"['joo', 'mla', 'work']",3,13,4,9,30.77
reliablehomevaluation,96141,"['reliable', 'home', 'valuation']",3,21,11,10,52.38
summitfinancialdisclosure,96057,"['summit', 'financial', 'disclosure']",3,25,10,15,40.0
sinocokingchina,95390,"['sino', 'coking', 'china']",3,15,6,9,40.0
honeyagencyapps,95264,"['honey', 'agency', 'apps']",3,15,5,10,33.33
activespinetherapy,94804,"['active', 'spine', 'therapy']",3,18,7,11,38.89
meccinextgenerationmarket,94500,"['cci', 'next', 'generation', 'market']",4,25,10,15,40.0
eastendremodeling,94416,"['east', 'end', 'remodeling']",3,17,7,10,41.18
exponential-e,94106,['exponential'],1,13,6,7,46.15
superderivatives,93154,"['super', 'derivatives']",2,16,7,9,43.75
hiddensexwatch,92438,"['hidden', 'sex', 'watch']",3,14,4,10,28.57
freedownloadscenter,92271,"['free', 'downloads', 'center']",3,19,7,12,36.84
uni-frankfurt,91428,"['uni', 'frankfurt']",2,13,4,9,30.77
zhongfuauction,91358,"['zhong', 'auction']",2,14,6,8,42.86
tafjordconnect,91332,"['fjord', 'connect']",2,14,4,10,28.57
uni-bielefeld,91132,"['uni', 'bielefeld']",2,13,6,7,46.15
hotblognetwork,90638,"['hot', 'blog', 'network']",3,14,4,10,28.57
maraizi-enoal,90474,"['mar', 'aiz', 'eno']",3,13,7,6,53.85
highcpmrevenuegate,90380,"['high', 'revenue', 'gate']",3,18,7,11,38.89
americommerce,89938,"['meri', 'commerce']",2,13,6,7,46.15
whitegenerator,89658,"['white', 'generator']",2,14,6,8,42.86
sdncommunications,89309,['communications'],1,17,6,11,35.29
theupsstorelocal,88994,"['the', 'ups', 'store', 'local']",4,16,6,10,37.5
breezeprojects,88467,"['breeze', 'projects']",2,14,5,9,35.71
heading-century,88347,"['heading', 'century']",2,15,5,10,33.33
schedom-europe,88208,"['sch', 'edom', 'europe']",3,14,6,8,42.86
xenapponazure,87726,"['xena', 'azure']",2,13,6,7,46.15
referralcandy,87634,"['referral', 'candy']",2,13,4,9,30.77
getusermanual,86986,"['get', 'user', 'manual']",3,13,6,7,46.15
financeeastmoney,86974,"['finance', 'east', 'money']",3,16,7,9,43.75
discountstoresdir,86676,"['discount', 'stores', 'dir']",3,17,6,11,35.29
telecablesantapola,86028,"['tele', 'cable', 'santa', 'pola']",4,18,8,10,44.44
edelundstein-saar,85968,"['edel', 'und', 'stein', 'saar']",4,17,7,10,41.18
coremedictravel,85848,"['core', 'medic', 'travel']",3,15,6,9,40.0
somersetpharm,85686,"['somerset', 'harm']",2,13,4,9,30.77
webspacemania,85680,"['web', 'space', 'mania']",3,13,6,7,46.15
softsyshosting,85427,"['soft', 'hosting']",2,14,3,11,21.43
enginefaultcode,84935,"['engine', 'fault', 'code']",3,15,7,8,46.67
legal-aid-311,84546,"['legal', 'aid', '311']",3,13,4,9,30.77
comcastbusiness,84360,"['comcast', 'business']",2,15,5,10,33.33
championbroadband,84330,"['champion', 'broadband']",2,17,6,11,35.29
plentysystems,84290,"['plenty', 'systems']",2,13,2,11,15.38
profinda-staging,84213,"['pro', 'find', 'staging']",3,16,5,11,31.25
hostedmxserver,84024,"['hosted', 'server']",2,14,4,10,28.57
znakomstva-intim,83844,"['kom', 'stv', 'tim']",3,16,5,11,31.25
curanetserver,83799,"['cura', 'net', 'server']",3,13,5,8,38.46
freshmarketeer,83797,"['fresh', 'market']",2,14,5,9,35.71
ningboershouche,83772,"['ning', 'boer', 'shou', 'che']",4,15,6,9,40.0
nastyvideodating,82997,"['nasty', 'video', 'dating']",3,16,6,10,37.5
metalsilver-overdrive,82588,"['metal', 'silver', 'overdrive']",3,21,8,13,38.1
measurementapi,82566,"['measurement', 'api']",2,14,7,7,50.0
onlinehome-server,81694,"['online', 'home', 'server']",3,17,7,10,41.18
huarachesshoes,81150,"['hua', 'rache', 'shoes']",3,14,6,8,42.86
australian-business-online,80982,"['australian', 'business', 'online']",3,26,11,15,42.31
hotsexyandbigtity,80860,"['hot', 'sexy', 'and', 'big']",4,17,5,12,29.41
sparkpostmail,80729,"['spark', 'post', 'mail']",3,13,4,9,30.77
radiostream321,80611,"['radio', 'stream', '321']",3,14,5,9,35.71
executivadigital,80496,"['exe', 'cut', 'digital']",3,16,8,8,50.0
allhotelscalifornia,80114,"['all', 'hotels', 'california']",3,19,8,11,42.11
fastwebserver,80094,"['fast', 'web', 'server']",3,13,4,9,30.77
arteria-hikari,79977,"['arte', 'ria', 'hikari']",3,14,7,7,50.0
businessinternet,79922,"['business', 'internet']",2,16,6,10,37.5
tiexinhuafang,79476,"['tie', 'xinhua', 'fang']",3,13,6,7,46.15
astra2connect,79335,"['astra', 'connect']",2,13,4,9,30.77
topdestination,79233,"['top', 'destination']",2,14,6,8,42.86
porntubekingdom,79229,"['porn', 'tube', 'kingdom']",3,15,5,10,33.33
uni-tuebingen,78828,"['uni', 'tue', 'bingen']",3,13,6,7,46.15
profitablegatetocontent,78810,"['profitable', 'gate', 'content']",3,23,9,14,39.13
allhotelstexas,78798,"['all', 'hotels', 'texas']",3,14,5,9,35.71
uni-regensburg,78738,"['uni', 'regensburg']",2,14,5,9,35.71
ifddosthenkill,78194,"['dos', 'then', 'kill']",3,14,4,10,28.57
brescobroadband,78066,"['bres', 'broadband']",2,15,5,10,33.33
besthearingaid365,77403,"['best', 'hearing', 'aid', '365']",4,17,6,11,35.29
kerrymatthews,77016,"['kerry', 'matthews']",2,13,3,10,23.08
ssdcloudindia,76478,"['ssd', 'cloud', 'india']",3,13,5,8,38.46
extensionfile,76362,"['extension', 'file']",2,13,6,7,46.15
bloggersdelight,76308,"['bloggers', 'delight']",2,15,4,11,26.67
bangordailynews,76134,"['bangor', 'daily', 'news']",3,15,5,10,33.33
icsincorporated,75990,"['ics', 'incorporated']",2,15,6,9,40.0
the3rdgeneration,75851,"['the', 'generation']",2,16,6,10,37.5
brandyourself,75420,"['brand', 'yourself']",2,13,4,9,30.77
establishlink,75368,"['establish', 'link']",2,13,4,9,30.77
yourhostingaccount,74796,"['your', 'hosting', 'account']",3,18,7,11,38.89
ispnetbilling,74556,"['isp', 'net', 'billing']",3,13,4,9,30.77
quanben-xiaoshuo,74244,"['quan', 'ben', 'xiao', 'huo']",4,16,8,8,50.0
skincaretherapy,74151,"['skin', 'care', 'therapy']",3,15,5,10,33.33
perspektivbredband,74044,"['per', 'pek', 'bred', 'band']",4,18,5,13,27.78
terrariumsolutions,73929,"['terrarium', 'solutions']",2,18,8,10,44.44
die-werbeagentur-pforzheim,73716,"['die', 'wer', 'agent', 'pforzheim']",4,26,10,16,38.46
admiralhosting,73377,"['admiral', 'hosting']",2,14,5,9,35.71
jouwstartonline,73197,"['jou', 'start', 'online']",3,15,6,9,40.0
zacher-bochum,73167,"['zac', 'her', 'bochum']",3,13,4,9,30.77
board-directory,73085,"['board', 'directory']",2,15,5,10,33.33
tripleplugandplay,73025,"['triple', 'plug', 'and', 'play']",4,17,5,12,29.41
firebrandstore,72936,"['firebrand', 'store']",2,14,5,9,35.71
thiccchicksfinder,72636,"['icc', 'chicks', 'finder']",3,17,4,13,23.53
onenightpartnersfinder,72636,"['one', 'night', 'partners', 'finder']",4,22,7,15,31.82
onlineservices,72570,"['online', 'services']",2,14,6,8,42.86
onenightladiesfinder,72474,"['one', 'night', 'ladies', 'finder']",4,20,8,12,40.0
lovelyslutsfinder,72474,"['lovely', 'sluts', 'finder']",3,17,5,12,29.41
lovelygirlsfinder,72474,"['lovely', 'girls', 'finder']",3,17,5,12,29.41
freehotelguide,72382,"['free', 'hotel', 'guide']",3,14,7,7,50.0
izmiryetkiliservisi,72248,"['izmir', 'yet', 'lise', 'rvis']",4,19,8,11,42.11
hotels-in-netherlands,72235,"['hotels', 'netherlands']",2,21,6,15,28.57
profitablegate,71880,"['profitable', 'gate']",2,14,6,8,42.86
highperformancecpmgate,71800,"['high', 'performance', 'gate']",3,22,7,15,31.82
hearing-aid45,71584,"['hearing', 'aid']",2,13,5,8,38.46
phibee-telecom,71474,"['phi', 'bee', 'telecom']",3,14,6,8,42.86
startpleintje,71256,"['start', 'plein']",2,13,4,9,30.77
hgsitebuilder,71238,"['site', 'builder']",2,13,5,8,38.46
tophotelsrome,71091,"['top', 'hotels', 'rome']",3,13,5,8,38.46
outsystemscloud,70981,"['out', 'systems', 'cloud']",3,15,5,10,33.33
brownpapertickets,70622,"['brown', 'paper', 'tickets']",3,17,5,12,29.41
trustexporter,69659,"['trust', 'exporter']",2,13,4,9,30.77
bali-tophotels,69513,"['bali', 'top', 'hotels']",3,14,5,9,35.71
bestgirlsexposed,69435,"['best', 'girls', 'exposed']",3,16,5,11,31.25
visittangshan,69430,"['visit', 'tangshan']",2,13,4,9,30.77
yumeixiaomian,69274,"['yume', 'xiao', 'mian']",3,13,8,5,61.54
branchen-info,68518,"['branch', 'info']",2,13,4,9,30.77
netzwerk-service-hamburg,68484,"['net', 'service', 'hamburg']",3,24,7,17,29.17
soderhamn-net,68074,"['oder', 'ham', 'net']",3,13,4,9,30.77
congressnewsletter,67639,"['congress', 'newsletter']",2,18,5,13,27.78
supercell-officials,67236,"['supercell', 'officials']",2,19,7,12,36.84
3a-administration,67080,['administration'],1,17,7,10,41.18
trustedcpmrevenue,67020,"['trusted', 'revenue']",2,17,6,11,35.29
conectabalear,66999,"['cone', 'cta', 'balear']",3,13,6,7,46.15
zinndorfer-zwerge,66768,"['zinn', 'dor', 'fer', 'wer']",4,17,5,12,29.41
quickcashloans,66737,"['quick', 'cash', 'loans']",3,14,5,9,35.71
apparatusgroup,66554,"['apparatus', 'group']",2,14,6,8,42.86
comendosystems,66435,"['com', 'endo', 'systems']",3,14,4,10,28.57
mijnstartonline,66276,"['start', 'online']",2,15,5,10,33.33
allwebsitestats,66139,"['all', 'website', 'stats']",3,15,5,10,33.33
connectedcommunity,65608,"['connected', 'community']",2,18,6,12,33.33
thetechisgood69,65572,"['the', 'tech', 'good']",3,15,5,10,33.33
hearingaid-6661,65264,"['hearing', 'aid', '6661']",3,15,5,10,33.33
all-balihotels,65058,"['all', 'bali', 'hotels']",3,14,5,9,35.71
emailsolution,64899,"['email', 'solution']",2,13,7,6,53.85
bigwheelbarrow,64773,"['big', 'wheelbarrow']",2,14,5,9,35.71
americanexpress,64517,"['american', 'express']",2,15,6,9,40.0
clientescreceri,64178,"['client', 'esc', 'rec', 'eri']",4,15,6,9,40.0
bluestreamcable,64142,"['blue', 'stream', 'cable']",3,15,6,9,40.0
dongfengdaoju,63987,"['dong', 'feng', 'dao']",3,13,5,8,38.46
uni-wuerzburg,63795,"['uni', 'rzburg']",2,13,5,8,38.46
pornblogreview,63744,"['porn', 'blog', 'review']",3,14,5,9,35.71
track-my-order-1,63607,"['track', 'order']",2,16,3,13,18.75
forumcommunity,63411,"['forum', 'community']",2,14,5,9,35.71
hotels-argentina,63270,"['hotels', 'argentina']",2,16,6,10,37.5
patmos-in-greece,63192,"['patmos', 'greece']",2,16,6,10,37.5
freierkindergarten,63132,"['freie', 'kindergarten']",2,18,7,11,38.89
greenmountainaccess,63090,"['green', 'mountain', 'access']",3,19,8,11,42.11
ilovetranslation,62913,"['love', 'translation']",2,16,7,9,43.75
toptenreviews,62663,"['top', 'ten', 'reviews']",3,13,5,8,38.46
inside-center,62322,"['inside', 'center']",2,13,5,8,38.46
lianyanghealth,62026,"['anyang', 'health']",2,14,5,9,35.71
bustedcamgirls,61893,"['busted', 'cam', 'girls']",3,14,4,10,28.57
tischlerei-fiedler,61524,"['tisch', 'rei', 'fiedler']",3,18,7,11,38.89
myjazznetwork,61322,"['jazz', 'network']",2,13,3,10,23.08
widencollective,61274,"['widen', 'collective']",2,15,6,9,40.0
meineoeffnungszeiten,60822,"['mei', 'neo', 'eff', 'nun', 'zeit']",5,20,9,11,45.0
newtelsolutions,60810,"['new', 'tel', 'solutions']",3,15,6,9,40.0
optimalworkshop,60652,"['optimal', 'workshop']",2,15,5,10,33.33
logansroadhousejobs,60507,"['logan', 'roadhouse', 'jobs']",3,19,8,11,42.11
open-telekom-cloud,60498,"['open', 'telekom', 'cloud']",3,18,7,11,38.89
top-hotels-switzerland,60387,"['top', 'hotels', 'switzerland']",3,22,6,16,27.27
smallworldlabs,60379,"['small', 'world', 'labs']",3,14,3,11,21.43
skimresources,60367,"['skim', 'resources']",2,13,5,8,38.46
dom-rubio-geschichten,60240,"['dom', 'rubio', 'geschichte']",3,21,7,14,33.33
sentimentmetrics,59995,"['sentiment', 'metrics']",2,16,5,11,31.25
dsredirection,59919,['redirection'],1,13,5,8,38.46
neurosciences,59903,['neuroscience'],1,13,6,7,46.15
voirstreamingvf,59868,"['voir', 'streaming']",2,15,5,10,33.33
unknownsecret,59798,"['unknown', 'secret']",2,13,4,9,30.77
premieronline,59730,"['premier', 'online']",2,13,6,7,46.15
dentalqoretemp,59668,"['dental', 'ore', 'temp']",3,14,5,9,35.71
homeworksinternet,59551,"['home', 'works', 'internet']",3,17,6,11,35.29
format-staging,59475,"['format', 'staging']",2,14,4,10,28.57
soft32download,59295,"['soft', 'download']",2,14,4,10,28.57
uberflip-stg1,59077,"['uber', 'flip']",2,13,3,10,23.08
nordictelecom,59055,"['nordic', 'telecom']",2,13,5,8,38.46
americanlisted,58845,"['american', 'listed']",2,14,6,8,42.86
getpaid90persurvey,58830,"['get', 'paid', 'per', 'survey']",4,18,6,12,33.33
cityvisionocchiali,57991,"['city', 'vision', 'chi', 'ali']",4,18,8,10,44.44
ingenieria-cucciardi,57822,"['genie', 'ria', 'ciar']",3,20,10,10,50.0
uni-hohenheim,57708,"['uni', 'hohenheim']",2,13,6,7,46.15
hearing-aid-101,57537,"['hearing', 'aid', '101']",3,15,5,10,33.33
virginia-horn,57252,"['virginia', 'horn']",2,13,5,8,38.46
global-free-classified-ads,57081,"['global', 'free', 'classified', 'ads']",4,26,9,17,34.62
uslugi-koparkowe,57024,"['slug', 'park', 'owe']",3,16,7,9,43.75
vorwerk-digital,56684,"['vor', 'digital']",2,15,5,10,33.33
lingxianmotor,56444,"['ling', 'xian', 'motor']",3,13,5,8,38.46
optimalresume,56313,"['optimal', 'resume']",2,13,6,7,46.15
splashrelease,56047,"['splash', 'release']",2,13,5,8,38.46
buchholz-digital,55995,"['buchholz', 'digital']",2,16,5,11,31.25
adstshirtmensshop,55916,"['dst', 'shirt', 'mens', 'shop']",4,17,4,13,23.53
stellamariscollege,55816,"['stella', 'maris', 'college']",3,18,7,11,38.89
bitcoindevkit,55740,"['bitcoin', 'dev', 'kit']",3,13,5,8,38.46
joomla-agentur-pforzheim,55716,"['joo', 'mla', 'agent', 'pforzheim']",4,24,9,15,37.5
effectivecpmgate,55710,"['effective', 'gate']",2,16,6,10,37.5
freedomsoftsites,55197,"['freedom', 'soft', 'sites']",3,16,6,10,37.5
h5datacenters,55088,['datacenter'],1,13,4,9,30.77
place-advisor,55057,"['place', 'advisor']",2,13,5,8,38.46
schefel-weinberg,55044,"['chef', 'weinberg']",2,16,5,11,31.25
auditoriumsrape,54936,"['auditoriums', 'rape']",2,15,8,7,53.33
kocaeliyetkiliservis,54894,"['kocaeli', 'yet', 'lise', 'rvis']",4,20,9,11,45.0
hearing-aid12,54868,"['hearing', 'aid']",2,13,5,8,38.46
cloudwaysapps,54847,"['cloud', 'ways', 'apps']",3,13,4,9,30.77
nothingbutbasketball,54788,"['nothing', 'but', 'basketball']",3,20,6,14,30.0
compagniedesalpes,54700,"['compagnie', 'des', 'alpes']",3,17,7,10,41.18
recetascomidas,54357,"['cet', 'asco', 'mid']",3,14,6,8,42.86
iledefrance-hotel,54276,"['ile', 'france', 'hotel']",3,17,7,10,41.18
amazonlightsail,54238,"['amazon', 'light', 'sail']",3,15,6,9,40.0
holzkugelschreiber,54164,"['holz', 'gel', 'schreiber']",3,18,6,12,33.33
imoncommunications,54012,['communications'],1,18,8,10,44.44
huaweicloudwaf,53938,"['hua', 'wei', 'cloud', 'waf']",4,14,7,7,50.0
cursosninsoft,53832,"['curs', 'soft']",2,13,4,9,30.77
wanzhuandapeng,53817,"['wan', 'zhu', 'and', 'peng']",4,14,5,9,35.71
babesvsrobots,53794,"['babes', 'robots']",2,13,4,9,30.77
wohnwelt-koeln,53676,"['woh', 'welt']",2,14,4,10,28.57
yourlifehelper,53616,"['your', 'life', 'helper']",3,14,6,8,42.86
vindhetviahier,53517,"['dhet', 'via', 'hier']",3,14,6,8,42.86
sebringcapital,53460,"['sebring', 'capital']",2,14,5,9,35.71
graphic-blast,53387,"['graphic', 'blast']",2,13,3,10,23.08
qiaoyuanyujia,53310,"['yuan', 'yuji']",2,13,8,5,61.54
zzshenglongkeji,53199,"['sheng', 'long']",2,15,4,11,26.67
financialaidtv,53141,"['financial', 'aid']",2,14,6,8,42.86
freepornhdxxx,53069,"['free', 'porn', 'xxx']",3,13,3,10,23.08
lastockphotos,52950,"['stock', 'photos']",2,13,4,9,30.77
mobileandroid-9996,52881,"['mobile', 'android', '9996']",3,18,6,12,33.33
free-underground,52872,"['free', 'underground']",2,16,6,10,37.5
personio-internal,52821,"['person', 'internal']",2,17,7,10,41.18
hebeis-events,52728,['events'],1,13,5,8,38.46
organic-food01,52473,"['organic', 'food']",2,14,5,9,35.71
dongliyangguang,52227,"['dong', 'yang', 'guang']",3,15,5,10,33.33
innovazioneperitale,52212,"['nov', 'azione', 'per', 'itale']",4,19,10,9,52.63
wordpresstemporal,52054,"['wordpress', 'temporal']",2,17,5,12,29.41
orange-business,51907,"['orange', 'business']",2,15,6,9,40.0
jeunesseglobal,51821,"['jeunes', 'global']",2,14,6,8,42.86
server-hosting,51693,"['server', 'hosting']",2,14,4,10,28.57
highperformancecpm,51654,"['high', 'performance']",2,18,5,13,27.78
adobe-campaign,51557,"['adobe', 'campaign']",2,14,6,8,42.86
cursodeespiritismo,51540,"['cur', 'dee', 'spiritism']",3,18,8,10,44.44
master-hosting,51352,"['master', 'hosting']",2,14,4,10,28.57
hotels-of-london,51299,"['hotels', 'london']",2,16,5,11,31.25
plutio-staging,51297,"['tio', 'staging']",2,14,5,9,35.71
unitedtelecom,51219,"['united', 'telecom']",2,13,6,7,46.15
haoxuezaixian,51106,"['hao', 'xue', 'zai', 'xian']",4,13,8,5,61.54
lpthomesearch,50898,"['thome', 'search']",2,13,4,9,30.77
landsofthesun,50876,"['lands', 'the', 'sun']",3,13,4,9,30.77
stillwaterschools,50875,"['stillwater', 'schools']",2,17,5,12,29.41
wushuiliuliangji,50814,"['wushu', 'liu', 'liang']",3,16,8,8,50.0
thiccadultsfinder,50764,"['icc', 'adults', 'finder']",3,17,5,12,29.41
servertools24,50739,"['server', 'tools']",2,13,4,9,30.77
top-hotels-uk,50688,"['top', 'hotels']",2,13,4,9,30.77
mastertelecom,50494,"['master', 'telecom']",2,13,5,8,38.46
implementcloud,50490,"['implement', 'cloud']",2,14,5,9,35.71
mitigationinternational,50434,"['mitigation', 'international']",2,23,11,12,47.83
superlocalfirm,50412,"['super', 'local', 'firm']",3,14,5,9,35.71
prytula-jewellery,50292,"['pry', 'tula', 'jewellery']",3,17,5,12,29.41
trustedgatetocontent,49890,"['trusted', 'gate', 'content']",3,20,7,13,35.0
uni-paderborn,49722,"['uni', 'paderborn']",2,13,5,8,38.46
whidbeyteldsl,49683,"['hid', 'bey', 'tel', 'dsl']",4,13,3,10,23.08
websitetestlink,49664,"['website', 'test', 'link']",3,15,5,10,33.33
spacecraftbrooklyn,49572,"['spacecraft', 'brooklyn']",2,18,5,13,27.78
church-robes-ue,49478,"['church', 'robes']",2,15,5,10,33.33
radiostream123,49461,"['radio', 'stream', '123']",3,14,5,9,35.71
highperformancegate,49390,"['high', 'performance', 'gate']",3,19,7,12,36.84
uni-goettingen,49329,"['uni', 'ttingen']",2,14,6,8,42.86
camgirlarchive,49308,"['cam', 'girl', 'archive']",3,14,5,9,35.71
demotivationalposters,49267,"['motivational', 'posters']",2,21,9,12,42.86
zone-telechargement,49230,"['zone', 'tele', 'charge', 'ment']",4,19,7,12,36.84
mygooddealday,49218,"['good', 'deal', 'day']",3,13,5,8,38.46
readingconnect,49170,"['reading', 'connect']",2,14,5,9,35.71
monsite-orange,48894,"['mon', 'site', 'orange']",3,14,6,8,42.86
hearing-aid-981,48889,"['hearing', 'aid', '981']",3,15,5,10,33.33
onestophoteldeals,48882,"['one', 'stop', 'hotel', 'deals']",4,17,7,10,41.18
utilitytelephone,48558,"['utility', 'telephone']",2,16,7,9,43.75
police-crimescenecleanup,48495,"['police', 'crime', 'scene', 'cleanup']",4,24,10,14,41.67
enginediagnosticcode,48480,"['engine', 'diagnostic', 'code']",3,20,9,11,45.0
hoffman-andrews,48321,"['hoffman', 'andrews']",2,15,4,11,26.67
hnonlinetraining,48275,"['online', 'training']",2,16,6,10,37.5
jingruipharma,48216,"['jing', 'rui', 'harm']",3,13,5,8,38.46
tribeplatform,48182,"['tribe', 'platform']",2,13,4,9,30.77
reverselookupanynumber,48157,"['reverse', 'lookup', 'any', 'number']",4,22,9,13,40.91
prospectportal,48156,"['prospect', 'portal']",2,14,4,10,28.57
justgoodbusiness,48120,"['just', 'good', 'business']",3,16,6,10,37.5
southplainscollege,48060,"['south', 'plains', 'college']",3,18,7,11,38.89
fitnessclubing,48026,"['fitness', 'club', 'ing']",3,14,4,10,28.57
ptcloudcontent,48012,"['cloud', 'content']",2,14,4,10,28.57
zakazat-nanyat-naiti,47928,"['zak', 'zat', 'any']",3,20,8,12,40.0
specialoftheday,47872,"['special', 'the', 'day']",3,15,6,9,40.0
instagramphotodownload,47672,"['insta', 'gram', 'photo', 'download']",4,22,8,14,36.36
maverickcoupon,47607,"['maverick', 'coupon']",2,14,6,8,42.86
buildonscenes,47496,"['build', 'scenes']",2,13,5,8,38.46
unibw-muenchen,47345,"['uni', 'nchen']",2,14,5,9,35.71
lazernetwireless,47038,"['laze', 'net', 'wireless']",3,16,6,10,37.5
mygoldaccount,46944,"['gold', 'account']",2,13,4,9,30.77
bicicletaselorza,46876,"['icicle', 'selo', 'rza']",3,16,7,9,43.75
hotelwithflight,46616,"['hotel', 'with', 'flight']",3,15,4,11,26.67
nulinkdigital,46602,"['link', 'digital']",2,13,5,8,38.46
chargebeeportal,46480,"['charge', 'bee', 'portal']",3,15,6,9,40.0
hearing-aid-971,46426,"['hearing', 'aid', '971']",3,15,5,10,33.33
consumer-debt-consolidation,46147,"['consumer', 'debt', 'consolidation']",3,27,10,17,37.04
autotroublecode,45798,"['auto', 'trouble', 'code']",3,15,8,7,53.33
dogbarkcollars-4less,45792,"['dog', 'bark', 'collars', 'less']",4,20,5,15,25.0
minhawebradio,45612,"['minh', 'web', 'radio']",3,13,6,7,46.15
infoturystyka,45528,"['fot', 'ury', 'sty']",3,13,4,9,30.77
downorblocked,45459,"['down', 'blocked']",2,13,4,9,30.77
blondelivesex,45261,"['blonde', 'live', 'sex']",3,13,5,8,38.46
mslafteburner,45204,"['msl', 'aft', 'burner']",3,13,4,9,30.77
nordiskpolska,44988,"['nor', 'disk', 'polska']",3,13,4,9,30.77
mypaydaycredit,44937,"['payday', 'credit']",2,14,4,10,28.57
fashionistblog,44918,"['fashion', 'blog']",2,14,5,9,35.71
profitablecpmgate,44840,"['profitable', 'gate']",2,17,6,11,35.29
kissimmeeflhotels,44814,"['kissimmee', 'hotels']",2,17,6,11,35.29
driving-tests,44622,"['driving', 'tests']",2,13,3,10,23.08
pideseloaalgore,44600,"['pide', 'selo', 'gore']",3,15,8,7,53.33
streamstorecloud,44520,"['stream', 'store', 'cloud']",3,16,6,10,37.5
kb4compliance,44452,['compliance'],1,13,4,9,30.77
metart-models,44322,"['met', 'art', 'models']",3,13,4,9,30.77
callax-network,44271,"['call', 'network']",2,14,4,10,28.57
dedicat-smtpbz,43974,"['dic', 'smtp']",2,14,3,11,21.43
greecemacedoniahotels,43966,"['greece', 'macedonia', 'hotels']",3,21,10,11,47.62
pokerdom-power,43923,"['poker', 'dom', 'power']",3,14,5,9,35.71
garnatioliveoil,43883,"['gar', 'nat', 'olive', 'oil']",4,15,8,7,53.33
jetspotnetworks,43795,"['jet', 'spot', 'networks']",3,15,4,11,26.67
powerblogsystem,43791,"['power', 'blog', 'system']",3,15,4,11,26.67
hotels-of-ukraine,43761,"['hotels', 'ukraine']",2,17,7,10,41.18
vitrinevirtual,43751,"['vitr', 'virtual']",2,14,6,8,42.86
besthotelscolorado,43661,"['best', 'hotels', 'colorado']",3,18,7,11,38.89
tuscanyitalyhotels,43629,"['tuscany', 'italy', 'hotels']",3,18,6,12,33.33
przedszkolowo,43596,"['zeds', 'low']",2,13,4,9,30.77
colegiosonline,43495,"['colegio', 'online']",2,14,7,7,50.0
cheaplivewebcams,43434,"['cheap', 'live', 'webcams']",3,16,6,10,37.5
budgetplanners,43377,"['budget', 'planners']",2,14,4,10,28.57
hydinternational,43289,['international'],1,16,6,10,37.5
avalon-technologies,43271,"['avalon', 'technologies']",2,19,8,11,42.11
elite-english-center,43110,"['elite', 'english', 'center']",3,20,7,13,35.0
greenlandfinancialservices,43084,"['greenland', 'financial', 'services']",3,26,10,16,38.46
mavenanalytics,43022,"['maven', 'analytics']",2,14,5,9,35.71
centralaccess,42972,"['central', 'access']",2,13,4,9,30.77
thoughtindustries,42897,"['thought', 'industries']",2,17,6,11,35.29
onlinenoffline,42697,"['linen', 'offline']",2,14,6,8,42.86
verticalcityhotel,42639,"['vertical', 'city', 'hotel']",3,17,6,11,35.29
lecongyunchuang,42593,"['lec', 'gyun', 'chuang']",3,15,5,10,33.33
feichangchina,42577,"['fei', 'chang', 'china']",3,13,5,8,38.46
onenightflingsfinder,42502,"['one', 'night', 'flings', 'finder']",4,20,6,14,30.0
meiliboertala,42436,"['meili', 'boer', 'tal']",3,13,7,6,53.85
spacemanworld,42391,"['spaceman', 'world']",2,13,4,9,30.77
tourism-hotels-bulgaria,42363,"['tourism', 'hotels', 'bulgaria']",3,23,9,14,39.13
niedrigepreise,42272,"['nie', 'rig', 'reise']",3,14,7,7,50.0
greenland-financialservices,42211,"['greenland', 'financial', 'services']",3,27,10,17,37.04
findikfiyatlari,42043,"['find', 'yat', 'lari']",3,15,6,9,40.0
strato-hosting,41974,"['strato', 'hosting']",2,14,4,10,28.57
sz-hongyunlai,41973,"['hong', 'yun', 'lai']",3,13,4,9,30.77
puskopditbkcukalimantan,41880,"['pus', 'kop', 'kalimantan']",3,23,8,15,34.78
beijinghengda,41849,"['beijing', 'ngd']",2,13,5,8,38.46
hotels-sicily,41721,"['hotels', 'sicily']",2,13,4,9,30.77
fineartamerica,41620,"['fine', 'art', 'america']",3,14,7,7,50.0
nieruchomosci-online,41496,"['nie', 'ruc', 'homo', 'sci', 'online']",5,20,9,11,45.0
syringanetworks,41473,"['syringa', 'networks']",2,15,4,11,26.67
mianzhenxiang,41349,"['mian', 'zhen', 'xiang']",3,13,5,8,38.46
gelateriadolz,41340,['later'],1,13,6,7,46.15
azurestaticapps,41334,"['azure', 'static', 'apps']",3,15,6,9,40.0
arcpublishing,41267,"['arc', 'publishing']",2,13,4,9,30.77
resalepartners,41253,"['resale', 'partners']",2,14,5,9,35.71
univ-st-etienne,41246,['etienne'],1,15,6,9,40.0
redbullmobile,41243,"['red', 'bull', 'mobile']",3,13,5,8,38.46
plantillasdemo,41146,"['plant', 'ill', 'demo']",3,14,5,9,35.71
zahnarzt-dolle,40956,"['zah', 'nar', 'doll']",3,14,4,10,28.57
golden-palais,40920,"['golden', 'palais']",2,13,5,8,38.46
payday-loan-yes,40896,"['payday', 'loan', 'yes']",3,15,5,10,33.33
tierarzt-information,40846,"['tier', 'information']",2,20,8,12,40.0
hrdrivehiring,40837,"['drive', 'hiring']",2,13,4,9,30.77
heartlandfiber,40786,"['heartland', 'fiber']",2,14,5,9,35.71
hypnose-friede,40776,"['hypnos', 'fried']",2,14,5,9,35.71
get-paid-90-persurvey,40771,"['get', 'paid', 'per', 'survey']",4,21,6,15,28.57
arbeitskreismediation,40716,"['arbeit', 'kreis', 'mediation']",3,21,10,11,47.62
thunderstresser,40599,"['thunder', 'stress']",2,15,4,11,26.67
fukangyuanyanglao,40143,"['kang', 'yuan', 'yang', 'lao']",4,17,7,10,41.18
sportschule-luna,40140,"['sport', 'schule', 'luna']",3,16,5,11,31.25
yalecarolinas,40055,"['yale', 'carolinas']",2,13,6,7,46.15
lightningstep,40052,"['lightning', 'step']",2,13,3,10,23.08
jaguar-network,40032,"['jaguar', 'network']",2,14,5,9,35.71
bero-webspace,40020,"['web', 'space']",2,13,5,8,38.46
adsjacketswomens,40009,"['ads', 'jackets', 'womens']",3,16,5,11,31.25
yogamonkeyfitness,40002,"['yoga', 'monkey', 'fitness']",3,17,6,11,35.29
staging-airtableblocks,39950,"['staging', 'air', 'table', 'blocks']",4,22,7,15,31.82
supergeschenk,39869,"['super', 'schenk']",2,13,4,9,30.77
sugarondemand,39842,"['sugar', 'demand']",2,13,5,8,38.46
lasalvxingshe,39841,"['las', 'xing', 'she']",3,13,4,9,30.77
ilcannocchiale,39753,"['can', 'noc', 'chia']",3,14,6,8,42.86
ocgreenrealty,39748,"['green', 'realty']",2,13,5,8,38.46
dandomainserver,39573,"['dando', 'main', 'server']",3,15,6,9,40.0
helpme-makemoney,39555,"['help', 'make', 'money']",3,16,6,10,37.5
paperbackswap,39519,"['paperback', 'swap']",2,13,4,9,30.77
hatchbusiness,39418,"['hatch', 'business']",2,13,4,9,30.77
sustainablefashionstyles,39204,"['sustainable', 'fashion', 'styles']",3,24,9,15,37.5
ussindianabb58,39180,"['uss', 'indian', 'abb']",3,14,5,9,35.71
soporteparatu,39084,"['porte', 'para']",2,13,6,7,46.15
imperialmanagement,39020,"['imperial', 'management']",2,18,8,10,44.44
movies-hd720p-online,38952,"['movies', '720', 'online']",3,20,6,14,30.0
nederland-web,38904,"['nederland', 'web']",2,13,4,9,30.77
discoveryeduction,38796,"['discovery', 'duct', 'ion']",3,17,7,10,41.18
calcicamptroop,38710,"['calc', 'camp', 'troop']",3,14,5,9,35.71
walgreenscoupons,38680,"['walgreens', 'coupons']",2,16,6,10,37.5
beyonddatacenter,38675,"['beyond', 'datacenter']",2,16,6,10,37.5
ruizhongxiang,38611,"['ruiz', 'hong', 'xiang']",3,13,5,8,38.46
tributecenteronline,38565,"['tribute', 'center', 'online']",3,19,8,11,42.11
rencontres-rondes,38490,"['ren', 'contre', 'ronde']",3,17,5,12,29.41
mercator-inkasso,38460,"['mercator', 'ink']",2,16,6,10,37.5
xinfengyingxiao,38420,"['feng', 'ying', 'xiao']",3,15,6,9,40.0
technolutions,38347,"['techno', 'ions']",2,13,5,8,38.46
mortgage-application,38303,"['mortgage', 'application']",2,20,8,12,40.0
systemfactory,38291,"['system', 'factory']",2,13,3,10,23.08
bbconsusumerservc,38112,"['bbc', 'sumer', 'ser']",3,17,5,12,29.41
campbell-maria,38106,"['campbell', 'maria']",2,14,5,9,35.71
creactivemediagroup,38036,"['reactive', 'media', 'group']",3,19,9,10,47.37
riodejaneirohotelguide,37911,"['rio', 'janeiro', 'hotel', 'guide']",4,22,12,10,54.55
seniorclub-rencontre,37893,"['senior', 'club', 'ren', 'contre']",4,20,7,13,35.0
conertonerosco,37869,"['cone', 'rton', 'eros']",3,14,6,8,42.86
kanazawacable,37722,"['kanazawa', 'cable']",2,13,6,7,46.15
templatehotspot,37680,"['template', 'hotspot']",2,15,5,10,33.33
invisionservice,37568,"['vision', 'service']",2,15,7,8,46.67
yizhensheying,37518,"['zhen', 'she', 'ying']",3,13,4,9,30.77
domizil-mediterran,37503,"['miz', 'medi', 'terran']",3,18,7,11,38.89
blackbaud-sites,37277,"['black', 'baud', 'sites']",3,15,5,10,33.33
mymortgage-online,37263,"['mortgage', 'online']",2,17,6,11,35.29
checkappointments,37250,"['check', 'appointments']",2,17,5,12,29.41
supportbricks,37128,"['support', 'bricks']",2,13,3,10,23.08
greatmindstech,37118,"['great', 'minds', 'tech']",3,14,4,10,28.57
meienkouqiang,37106,"['mei', 'kou', 'qiang']",3,13,7,6,53.85
flashtimestudios,37054,"['flash', 'time', 'studios']",3,16,6,10,37.5
paymentnotice,37020,"['payment', 'notice']",2,13,5,8,38.46
pushpayevents,37005,"['push', 'pay', 'events']",3,13,4,9,30.77
haijingfang258,37005,"['hai', 'jing', 'fang', '258']",4,14,4,10,28.57
comocreartuweb,36952,"['como', 'artu', 'web']",3,14,6,8,42.86
frontendserviceaccount,36947,"['frontend', 'service', 'account']",3,22,8,14,36.36
sensualwriter,36924,"['sensual', 'writer']",2,13,5,8,38.46
hostingnetwork,36835,"['hosting', 'network']",2,14,4,10,28.57
theadvisrboss,36822,"['the', 'adv', 'boss']",3,13,4,9,30.77
americandatanetworks,36774,"['american', 'data', 'networks']",3,20,8,12,40.0
frenchfounders,36768,"['french', 'founders']",2,14,4,10,28.57
indecentblogging,36630,"['indecent', 'blogging']",2,16,5,11,31.25
lombardytophotels,36615,"['lombardy', 'top', 'hotels']",3,17,5,12,29.41
alfahosting-vps,36610,"['alfa', 'hosting']",2,15,4,11,26.67
restaurants800,36586,"['restaurants', '800']",2,14,4,10,28.57
consumergental,36298,"['consumer', 'gent']",2,14,5,9,35.71
deliciouslife,36262,"['delicious', 'life']",2,13,7,6,53.85
jogjamedianet,36180,"['jog', 'media', 'net']",3,13,6,7,46.15
homepage-alpaka,36129,"['homepage', 'paka']",2,15,7,8,46.67
cataloniatophotels,36102,"['catalonia', 'top', 'hotels']",3,18,8,10,44.44
norinco-motors,36100,"['nor', 'motors']",2,14,5,9,35.71
hotels-veneto,36099,"['hotels', 'veneto']",2,13,5,8,38.46
upsstoreprint,36084,"['ups', 'store', 'print']",3,13,4,9,30.77
securepersonalamz,36060,"['secure', 'personal']",2,17,7,10,41.18
hotelsonsicily,36042,"['hotels', 'sicily']",2,14,5,9,35.71
xiaowutongxuemm,36002,"['xiao', 'tong', 'xue']",3,15,7,8,46.67
fastvps-server,35963,"['fast', 'server']",2,14,3,11,21.43
xinhuidianhuanbao,35912,"['hui', 'dian', 'huan', 'bao']",4,17,9,8,52.94
masoneilan-valve,35909,"['mas', 'one', 'ilan', 'valve']",4,16,7,9,43.75
shjinyuantang,35908,"['yuan', 'tang']",2,13,4,9,30.77
hainan-yuanzhen,35890,"['hainan', 'yuan', 'zhen']",3,15,6,9,40.0
worldwithoutwire,35886,"['world', 'without', 'wire']",3,16,6,10,37.5
alternativecpmgate,35850,"['alternative', 'gate']",2,18,7,11,38.89
betmoongirisi,35844,"['bet', 'moon', 'gir']",3,13,6,7,46.15
istanbulservisi,35824,"['istanbul', 'rvis']",2,15,6,9,40.0
guochaoshidai,35776,"['guo', 'chaos', 'hida']",3,13,7,6,53.85
leprovence-hotel,35763,"['provence', 'hotel']",2,16,6,10,37.5
tianaijiankang,35693,"['tian', 'iji', 'kang']",3,14,7,7,50.0
isionline-dialin,35688,"['online', 'dial']",2,16,8,8,50.0
shanghai-iedu,35624,"['shanghai', 'edu']",2,13,6,7,46.15
crazy-factory,35584,"['crazy', 'factory']",2,13,3,10,23.08
pickup-trucks,35575,"['pickup', 'trucks']",2,13,3,10,23.08
jewelleryandgemstones,35517,"['jewellery', 'and', 'gemstones']",3,21,7,14,33.33
livesex-livesex,35415,"['live', 'sex', 'live', 'sex']",4,15,6,9,40.0
emailantidote,35249,"['email', 'antidote']",2,13,7,6,53.85
punchlineradio,35172,"['punchline', 'radio']",2,14,6,8,42.86
edirectorycloud,35081,"['directory', 'cloud']",2,15,6,9,40.0
acropolistelecom,35007,"['acropolis', 'telecom']",2,16,7,9,43.75
smartproperty,34916,"['smart', 'property']",2,13,3,10,23.08
nelson-textiles,34692,"['nelson', 'textiles']",2,15,5,10,33.33
vintagecarparts,34678,"['vintage', 'car', 'parts']",3,15,5,10,33.33
revenuenetworkcpm,34650,"['revenue', 'network']",2,17,6,11,35.29
online-winkelstart,34608,"['online', 'winkel', 'start']",3,18,6,12,33.33
xiuxianonline,34599,"['xian', 'online']",2,13,7,6,53.85
reservecougar,34515,"['reserve', 'cougar']",2,13,6,7,46.15
cuentasexpress,34512,"['cue', 'express']",2,14,5,9,35.71
race-x-change,34508,"['race', 'change']",2,13,4,9,30.77
panoramicwebcams,34416,"['panoramic', 'webcams']",2,16,6,10,37.5
dimensionesrl,34185,['dimension'],1,13,5,8,38.46
sanbrunocable,34158,"['san', 'bruno', 'cable']",3,13,5,8,38.46
shipping-portal,34076,"['shipping', 'portal']",2,15,4,11,26.67
premiumdomains,34012,"['premium', 'domains']",2,14,6,8,42.86
hostingterbaru,33818,"['hosting', 'ter', 'baru']",3,14,5,9,35.71
chineseclivia,33790,"['chinese', 'livia']",2,13,6,7,46.15
hs-osnabrueck,33565,"['osnabr', 'eck']",2,13,4,9,30.77
sakaryaservisi,33504,"['kary', 'rvis']",2,14,6,8,42.86
huirongrealestate,33421,"['hui', 'rong', 'real', 'estate']",4,17,8,9,47.06
freeadultsexychat,33385,"['free', 'adult', 'sexy', 'chat']",4,17,6,11,35.29
univ-lorraine,33348,['lorraine'],1,13,6,7,46.15
mydigitalpublication,33244,"['digital', 'publication']",2,20,8,12,40.0
moreappsdevelopers,33190,"['more', 'apps', 'developers']",3,18,7,11,38.89
hotels-andalucia,33189,"['hotels', 'and', 'lucia']",3,16,7,9,43.75
sprintdatacenter,33169,"['sprint', 'datacenter']",2,16,5,11,31.25
lindascandals,33120,"['linda', 'scandals']",2,13,4,9,30.77
townsquareinteractive,33117,"['town', 'square', 'interactive']",3,21,9,12,42.86
twelve99-cust,33061,['twelve'],1,13,3,10,23.08
vip-medical-lounge,33024,"['vip', 'medical', 'lounge']",3,18,7,11,38.89
internettudakozo,32928,"['internet', 'tud', 'kozo']",3,16,7,9,43.75
treballsestudiants,32926,"['tre', 'balls', 'estudi', 'ants']",4,18,6,12,33.33
echangisme-rencontre,32919,"['chang', 'ren', 'contre']",3,20,7,13,35.0
washingtonlift,32871,"['washington', 'lift']",2,14,4,10,28.57
bavariahotels24,32829,"['bavaria', 'hotels']",2,15,6,9,40.0
wearelegalshield,32809,"['are', 'legal', 'shield']",3,16,7,9,43.75
prostitutki-13,32760,['prost'],1,14,4,10,28.57
uni-osnabrueck,32746,"['uni', 'osnabr', 'eck']",3,14,6,8,42.86
maruthiservices,32717,"['maru', 'thi', 'services']",3,15,6,9,40.0
hireteenagers,32697,"['hire', 'teenagers']",2,13,6,7,46.15
wecandobettermi,32694,"['can', 'better']",2,15,6,9,40.0
consolidatedebtus,32605,"['consolidate', 'debt']",2,17,7,10,41.18
livesexperformers,32586,"['live', 'sex', 'performers']",3,17,6,11,35.29
craigslistbest,32578,"['craigslist', 'best']",2,14,4,10,28.57
centumnetworks,32573,"['centum', 'networks']",2,14,4,10,28.57
forkliftservicesofamerica,32556,"['forklift', 'services', 'america']",3,25,10,15,40.0
performancetrustednetwork,32550,"['performance', 'trusted', 'network']",3,25,8,17,32.0
logancontractors,32467,"['logan', 'contractors']",2,16,5,11,31.25
mychristushealth,32466,"['christus', 'health']",2,16,4,12,25.0
bgmimobilesofficial,32466,"['mobiles', 'official']",2,19,8,11,42.11
sh-sunyat-sen,32417,"['suny', 'sen']",2,13,3,10,23.08
best-istanbul-hotels,32340,"['best', 'istanbul', 'hotels']",3,20,6,14,30.0
freehostalive,32328,"['free', 'host', 'alive']",3,13,6,7,46.15
msl-afteburner,32308,"['msl', 'aft', 'burner']",3,14,4,10,28.57
consignoraccess,32166,"['consign', 'access']",2,15,5,10,33.33
articulate-online,32140,"['articulate', 'online']",2,17,8,9,47.06
alternativagratis,32136,"['alter', 'nat', 'gratis']",3,17,7,10,41.18
marketnection,32124,"['market', 'nec', 'tion']",3,13,5,8,38.46
moderni-mebeli,32123,"['moderni', 'beli']",2,14,6,8,42.86
primarynetwork,32025,"['primary', 'network']",2,14,4,10,28.57
com-informationaccounts,32024,"['com', 'information', 'accounts']",3,23,9,14,39.13
realestateinfolkn,31995,"['real', 'estate', 'folk']",3,17,7,10,41.18
desoonproduct,31974,"['soon', 'product']",2,13,5,8,38.46
allshandonghotels,31950,"['all', 'shandong', 'hotels']",3,17,5,12,29.41
veracitynetworks,31887,"['veracity', 'networks']",2,16,5,11,31.25
aze88lxkjakdslijijlxkajdjcoom,31843,"['jak', 'dsl', 'iji', 'kaj']",4,29,8,21,27.59
hardhathosting,31825,"['hard', 'hat', 'hosting']",3,14,4,10,28.57
hamiltonteach,31824,"['hamilton', 'teach']",2,13,5,8,38.46
petersanomaly,31818,"['peters', 'anomaly']",2,13,5,8,38.46
mixingplantchina,31815,"['mixing', 'plant', 'china']",3,16,5,11,31.25
iranyitoszama,31794,"['iran', 'zama']",2,13,6,7,46.15
hotels-of-mallorca,31791,"['hotels', 'mallorca']",2,18,6,12,33.33
infusionstudios,31782,"['infusion', 'studios']",2,15,7,8,46.67
montanavision,31735,"['montana', 'vision']",2,13,6,7,46.15
bravenewwares,31726,"['brave', 'new', 'wares']",3,13,5,8,38.46
actualizetech,31711,"['actualize', 'tech']",2,13,6,7,46.15
jessicabennettinteriors,31364,"['jessica', 'bennett', 'interiors']",3,23,9,14,39.13
propertylogic,31191,"['property', 'logic']",2,13,4,9,30.77
virtuaoperator,31131,"['virtua', 'operator']",2,14,7,7,50.0
midwestfibernetworks,31089,"['midwest', 'fiber', 'networks']",3,20,6,14,30.0
areacode-lookup,31079,"['area', 'code', 'lookup']",3,15,8,7,53.33
alltrentinohotels,30897,"['all', 'trentino', 'hotels']",3,17,6,11,35.29
highrevenuecpm,30810,"['high', 'revenue']",2,14,5,9,35.71
kellsbeachcamping,30802,"['ells', 'beach', 'camping']",3,17,5,12,29.41
lollipopstick,30745,"['lollipop', 'stick']",2,13,4,9,30.77
rrpicturearchives,30710,"['picture', 'archives']",2,17,6,11,35.29
mexicoinsuranceonline,30610,"['mexico', 'insurance', 'online']",3,21,10,11,47.62
queenslandhotelmotel,30597,"['queensland', 'hotel', 'motel']",3,20,8,12,40.0
bluemoonanyer,30561,"['blue', 'moon', 'any']",3,13,6,7,46.15
chiens-de-france,30507,"['chien', 'france']",2,16,5,11,31.25
thebeststudfinder,30480,"['the', 'best', 'stud', 'finder']",4,17,5,12,29.41
getverifiedtoday,30432,"['get', 'verified', 'today']",3,16,7,9,43.75
xtremepowersports,30427,"['xtreme', 'power', 'sports']",3,17,5,12,29.41
starwindsoftware,30381,"['star', 'wind', 'software']",3,16,5,11,31.25
kabelszat2002,30343,"['abel', '2002']",2,13,3,10,23.08
siemens-energy,30327,"['siemens', 'energy']",2,14,5,9,35.71
reverselookups,30324,"['reverse', 'lookups']",2,14,6,8,42.86
freeinfovideo,30289,"['free', 'info', 'video']",3,13,7,6,53.85
highperformancecpmnetwork,30270,"['high', 'performance', 'network']",3,25,7,18,28.0
clientseoreport,30195,"['client', 'seo', 'report']",3,15,6,9,40.0
giantrecreationworld,30171,"['giant', 'recreation', 'world']",3,20,8,12,40.0
vahomebuyercenter,30128,"['home', 'buyer', 'center']",3,17,7,10,41.18
supportsystem,30119,"['support', 'system']",2,13,3,10,23.08
bigsexporntube,30102,"['big', 'sex', 'porn', 'tube']",4,14,5,9,35.71
falconbroadband,30066,"['falcon', 'broadband']",2,15,5,10,33.33
integer-research,30057,"['integer', 'research']",2,16,6,10,37.5
rainforesttravelcr,30048,"['rainforest', 'travel']",2,18,6,12,33.33
bakabonpachinko,30043,"['baka', 'bon', 'pachinko']",3,15,6,9,40.0
helpdocsonline,30029,"['help', 'docs', 'online']",3,14,5,9,35.71
qatestbigacc1,30000,"['test', 'big', 'acc']",3,13,4,9,30.77
qatestbigacc2,29994,"['test', 'big', 'acc']",3,13,4,9,30.77
linksandlodging,29991,"['links', 'and', 'lodging']",3,15,4,11,26.67
kontextoredirects,29962,"['kon', 'tex', 'redirects']",3,17,6,11,35.29
1stfamilygroup,29959,"['family', 'group']",2,14,4,10,28.57
easyredirengine,29886,"['easy', 'redir', 'engine']",3,15,7,8,46.67
bluehoststaff,29869,"['blue', 'host', 'staff']",3,13,4,9,30.77
studio-arcades,29856,"['studio', 'arcades']",2,14,6,8,42.86
passionandcharm,29808,"['passion', 'and', 'charm']",3,15,5,10,33.33
5foods0calories,29796,"['foods', 'calories']",2,15,6,9,40.0
hospedagemdesites,29728,"['sped', 'gem', 'sites']",3,17,7,10,41.18
intelelectrical,29607,"['intel', 'electrical']",2,15,6,9,40.0
globalamusement,29569,"['global', 'amusement']",2,15,6,9,40.0
jointalkfusion,29535,"['join', 'talk', 'fusion']",3,14,6,8,42.86
provedortiangua,29510,"['proved', 'tian', 'gua']",3,15,7,8,46.67
video-download,29467,"['video', 'download']",2,14,6,8,42.86
instadownloader,29457,"['insta', 'down', 'loader']",3,15,6,9,40.0
new-york-state,29424,"['new', 'york', 'state']",3,14,4,10,28.57
fundacionsinadep,29388,"['fundaci', 'dep']",2,16,7,9,43.75
cascadeaccess,29370,"['cascade', 'access']",2,13,5,8,38.46
acousticgiutar,29319,"['acoustic', 'tar']",2,14,7,7,50.0
humenjianming,29311,"['hume', 'nji', 'ming']",3,13,5,8,38.46
securanetworks,29224,"['cura', 'networks']",2,14,5,9,35.71
apartmentsandresidences,29214,"['apartments', 'and', 'residences']",3,23,8,15,34.78
to-barcelona-hotels,29175,"['barcelona', 'hotels']",2,19,7,12,36.84
rhone-alps-hotels,29118,"['rhone', 'alps', 'hotels']",3,17,5,12,29.41
thehardmoney-loans,29112,"['the', 'hard', 'money', 'loans']",4,18,6,12,33.33
sommerkleider2016,29112,"['sommer', 'eider', '2016']",3,17,5,12,29.41
ezfreightwebsites,29088,"['freight', 'websites']",2,17,6,11,35.29
atomicatpages,29062,"['atomic', 'pages']",2,13,6,7,46.15
romania-webhosting,29016,"['romania', 'web', 'hosting']",3,18,7,11,38.89
hotels-of-saint-petersburg,29004,"['hotels', 'saint', 'petersburg']",3,26,8,18,30.77
united-alliance,28957,"['united', 'alliance']",2,15,7,8,46.67
georgia-all-hotels,28955,"['georgia', 'all', 'hotels']",3,18,7,11,38.89
episodesworld,28944,"['episodes', 'world']",2,13,5,8,38.46
langesundskolemusikk,28944,"['langes', 'und', 'skol', 'emus', 'ikk']",5,20,7,13,35.0
modellbahnshop-koen,28944,"['model', 'bahn', 'shop']",3,19,6,13,31.58
livingstar-sub,28914,"['living', 'star', 'sub']",3,14,4,10,28.57
hotels-of-florence,28833,"['hotels', 'florence']",2,18,6,12,33.33
servicevideos,28830,"['service', 'videos']",2,13,6,7,46.15
secureservice,28824,"['secure', 'service']",2,13,6,7,46.15
gthod-umjarin,28811,"['hod', 'jar']",2,13,4,9,30.77
singlesaroundme,28798,"['singles', 'around']",2,15,6,9,40.0
australia2business,28767,"['australia', 'business']",2,18,8,10,44.44
gartenmoebel-aktuell,28739,"['garten', 'moe', 'bel', 'tue']",4,20,8,12,40.0
metzlermarketing,28707,"['metzler', 'marketing']",2,16,5,11,31.25
dreamplaymatesfinder,28704,"['dream', 'playmates', 'finder']",3,20,7,13,35.0
unlimitedpartnersfinder,28704,"['unlimited', 'partners', 'finder']",3,23,8,15,34.78
hotel-in-beijing,28647,"['hotel', 'beijing']",2,16,6,10,37.5
gmproductions,28636,['productions'],1,13,4,9,30.77
bestwealthnetwork,28632,"['best', 'wealth', 'network']",3,17,5,12,29.41
localhottestbabes,28577,"['local', 'hottest', 'babes']",3,17,6,11,35.29
nini-dinsdfsf,28574,"['dins', 'fsf']",2,13,3,10,23.08
macrosspachinko,28568,"['macross', 'pachinko']",2,15,5,10,33.33
performancepacing,28564,"['performance', 'pacing']",2,17,6,11,35.29
glazov-garant,28554,"['azov', 'rant']",2,13,4,9,30.77
incomrealestate,28544,"['com', 'real', 'estate']",3,15,7,8,46.67
cyberdevgroup,28542,"['cyber', 'dev', 'group']",3,13,4,9,30.77
booksknowledge,28458,"['books', 'knowledge']",2,14,5,9,35.71
therestaurant,28408,"['the', 'restaurant']",2,13,5,8,38.46
newsouthwaleshotels,28353,"['new', 'south', 'wales', 'hotels']",4,19,7,12,36.84
supremesurveillance,28292,"['supreme', 'surveillance']",2,19,8,11,42.11
poorunitedpolaris,28284,"['poor', 'united', 'polaris']",3,17,8,9,47.06
verificationsinc,28266,"['verification', 'inc']",2,16,7,9,43.75
heidongjiasuqi,28262,"['dong', 'jia']",2,14,7,7,50.0
slotdepositpulsa,28246,"['slot', 'deposit', 'pul']",3,16,6,10,37.5
superofertapara,28226,"['super', 'ert', 'para']",3,15,7,8,46.67
organicanonymous,28200,"['organic', 'anonymous']",2,16,7,9,43.75
lbctechnology,28200,"['lbc', 'technology']",2,13,3,10,23.08
patternbyetsy,28175,"['pattern', 'ets']",2,13,3,10,23.08
reversedphone,28172,"['reversed', 'phone']",2,13,5,8,38.46
processjobs11,28152,"['process', 'jobs']",2,13,3,10,23.08
retriv-discount,28150,['discount'],1,15,5,10,33.33
healtheintent,28060,"['heal', 'the', 'intent']",3,13,5,8,38.46
onlinevideoconverter,27985,"['online', 'video', 'converter']",3,20,9,11,45.0
cakemarketing,27928,"['cake', 'marketing']",2,13,5,8,38.46
myportallogin,27916,"['portal', 'login']",2,13,4,9,30.77
pacificlifestyle,27834,"['pacific', 'lifestyle']",2,16,6,10,37.5
best-moscow-hotels,27821,"['best', 'moscow', 'hotels']",3,18,5,13,27.78
frag-christel,27740,"['frag', 'christ']",2,13,3,10,23.08
evolutionstarbucks,27670,"['evolution', 'starbucks']",2,18,7,11,38.89
cretetophotels,27660,"['crete', 'top', 'hotels']",3,14,5,9,35.71
pictures-mycams,27619,"['pictures', 'cams']",2,15,4,11,26.67
ticketforevent,27584,"['ticket', 'for', 'event']",3,14,5,9,35.71
koreanlolyshop,27565,"['korean', 'lol', 'shop']",3,14,5,9,35.71
accessarkansas,27558,"['access', 'arkansas']",2,14,5,9,35.71
meicongjiaoyu,27539,"['mei', 'cong', 'jiao']",3,13,7,6,53.85
anpingshaiwang,27533,"['pings', 'hai', 'wang']",3,14,5,9,35.71
tuanmengyouxuanpt,27518,"['meng', 'you', 'xuan']",3,17,7,10,41.18
powerplustools,27518,"['power', 'plus', 'tools']",3,14,5,9,35.71
shutterchance,27504,"['shutter', 'chance']",2,13,4,9,30.77
herbalampuhmujarab,27492,"['herba', 'lamp', 'arab']",3,18,7,11,38.89
pipelinecourse,27488,"['pipeline', 'course']",2,14,7,7,50.0
chengzigaobao,27481,"['cheng', 'zig', 'aoba']",3,13,6,7,46.15
sitsanetworks,27443,"['sits', 'networks']",2,13,4,9,30.77
zidongtiancheng,27423,"['dong', 'tian', 'cheng']",3,15,5,10,33.33
molsencapital,27419,"['olsen', 'capital']",2,13,5,8,38.46
meilleur-plan-ds-trk,27408,"['ill', 'eur', 'plan']",3,20,5,15,25.0
bjjiyuntianxia,27402,"['jji', 'yun', 'tian', 'xia']",4,14,6,8,42.86
debtconsolidation-us,27384,"['debt', 'consolidation']",2,20,8,12,40.0
puwanglawfirm,27375,"['wang', 'law', 'firm']",3,13,4,9,30.77
shanxiwanjiakang,27364,"['shanxi', 'wan', 'jia', 'kang']",4,16,6,10,37.5
serversdirect,27337,"['servers', 'direct']",2,13,4,9,30.77
township-house,27312,"['township', 'house']",2,14,5,9,35.71
collegeadvisingcorps,27237,"['college', 'advising', 'corps']",3,20,7,13,35.0
visitzhongshan,27194,"['visit', 'zhong', 'shan']",3,14,4,10,28.57
discovercomplete,27184,"['discover', 'complete']",2,16,6,10,37.5
allthepassionstrings,27174,"['all', 'the', 'passion', 'strings']",4,20,6,14,30.0
cartaodevisita,27127,"['carta', 'ode', 'visit']",3,14,7,7,50.0
videoblocksdev,27104,"['video', 'blocks', 'dev']",3,14,5,9,35.71
idevaffiliate,27096,"['dev', 'affiliate']",2,13,7,6,53.85
renderforestsites,27068,"['render', 'forest', 'sites']",3,17,6,11,35.29
top-hotels-bg,27038,"['top', 'hotels']",2,13,3,10,23.08
shaoyusdfnnddcdn,27005,"['shao', 'usd', 'dcd']",3,16,3,13,18.75
adultsupermart,26979,"['adult', 'super', 'mart']",3,14,5,9,35.71
mutualofomaha,26958,"['mutual', 'omaha']",2,13,7,6,53.85
goedkoopste-taxatie,26949,"['koop', 'ste', 'taxa', 'tie']",4,19,9,10,47.37
greeneinkpress,26932,"['greene', 'ink', 'press']",3,14,5,9,35.71
myonlineserver,26896,"['online', 'server']",2,14,5,9,35.71
forex-brokers,26871,"['for', 'brokers']",2,13,4,9,30.77
parishotelsweb,26844,"['paris', 'hotels', 'web']",3,14,5,9,35.71
droidinformer,26787,"['droid', 'former']",2,13,5,8,38.46
highwaycpmrevenue,26750,"['highway', 'revenue']",2,17,6,11,35.29
guangyaoglass,26718,"['guang', 'yao', 'glass']",3,13,5,8,38.46
quickleasepro,26637,"['quick', 'lease', 'pro']",3,13,6,7,46.15
encompasstpoconnect,26633,"['encompass', 'connect']",2,19,6,13,31.58
livesexprofiles,26628,"['live', 'sex', 'profiles']",3,15,6,9,40.0
canary-islands-hotels,26625,"['canary', 'islands', 'hotels']",3,21,6,15,28.57
futurestafford,26623,"['future', 'stafford']",2,14,5,9,35.71
simplestrategyonline,26602,"['simple', 'strategy', 'online']",3,20,7,13,35.0
brunch-lunch-dinner,26589,"['brunch', 'lunch', 'dinner']",3,19,4,15,21.05
anglo-chinese,26589,"['anglo', 'chinese']",2,13,5,8,38.46
lifesciencefacts,26584,"['life', 'science', 'facts']",3,16,6,10,37.5
pohjanmaanpalvelut,26580,"['pohjanmaa', 'pal', 'vel']",3,18,7,11,38.89
epropertysites,26571,"['property', 'sites']",2,14,5,9,35.71
yanfengbazhou,26541,"['yan', 'feng', 'zhou']",3,13,5,8,38.46
rhinotruckbedliners,26510,"['rhino', 'truck', 'bed', 'liners']",4,19,6,13,31.58
1nstantcooler,26484,"['tant', 'cooler']",2,13,4,9,30.77
myperpetualsites,26462,"['perpetual', 'sites']",2,16,6,10,37.5
torianwallace,26424,"['tori', 'wallace']",2,13,6,7,46.15
powellfunerals,26385,"['powell', 'funerals']",2,14,5,9,35.71
profitabletrustednetwork,26340,"['profitable', 'trusted', 'network']",3,24,8,16,33.33
makemoneyworkshop,26307,"['make', 'money', 'workshop']",3,17,6,11,35.29
partsandaccessories,26274,"['parts', 'and', 'accessories']",3,19,7,12,36.84
mediterraneanhotels-tr,26244,"['mediterranean', 'hotels']",2,22,8,14,36.36
htwg-konstanz,26238,['konstanz'],1,13,2,11,15.38
doesmyloanqualify,26198,"['does', 'loan', 'qualify']",3,17,7,10,41.18
aurora-project,26181,"['aurora', 'project']",2,14,6,8,42.86
znakomstva-moskva,26169,"['kom', 'stv', 'moskva']",3,17,5,12,29.41
serverprofi24,26142,"['server', 'prof']",2,13,4,9,30.77
livecamsexporn,26138,"['live', 'cam', 'sex', 'porn']",4,14,5,9,35.71
lustychickser,26135,"['lusty', 'chicks']",2,13,3,10,23.08
tenderladiesbz,26135,"['tender', 'ladies']",2,14,5,9,35.71
firstvisioninternet,26124,"['first', 'vision', 'internet']",3,19,7,12,36.84
realsexathome,26079,"['real', 'sex', 'home']",3,13,6,7,46.15
facility-offer,26040,"['facility', 'offer']",2,14,5,9,35.71
lingwoodsoftware,25992,"['ling', 'wood', 'software']",3,16,6,10,37.5
servdiscount-customer,25991,"['ser', 'discount', 'customer']",3,21,7,14,33.33
brodietoyotalift,25982,"['bro', 'die', 'toyota', 'lift']",4,16,7,9,43.75
amateurtubegirls,25968,"['amateur', 'tube', 'girls']",3,16,7,9,43.75
storeandmercurid,25944,"['store', 'and', 'mer', 'rid']",4,16,6,10,37.5
cpmprofitablenetwork,25920,"['profitable', 'network']",2,20,6,14,30.0
hotwok-alsdorf,25896,"['hot', 'wok', 'als', 'dorf']",4,14,4,10,28.57
sfmc-marketing,25871,['marketing'],1,14,3,11,21.43
bangkokhotel24,25869,"['bangkok', 'hotel']",2,14,4,10,28.57
bardstowncable,25857,"['bardstown', 'cable']",2,14,4,10,28.57
thenewspaperofoccasions,25848,"['the', 'newspaper', 'occasions']",3,23,9,14,39.13
mykajabi-staging,25830,"['kaj', 'abi', 'staging']",3,16,5,11,31.25
emiliaromagnahotel,25731,"['emilia', 'romagna', 'hotel']",3,18,9,9,50.0
congress-neuro,25698,"['congress', 'neuro']",2,14,5,9,35.71
new-york-metropolitan-area,25692,"['new', 'york', 'metropolitan', 'area']",4,26,10,16,38.46
elliannajohnson,25668,"['ell', 'anna', 'johnson']",3,15,6,9,40.0
escortprotools,25666,"['escort', 'pro', 'tools']",3,14,5,9,35.71
railsplayground,25636,"['rails', 'playground']",2,15,5,10,33.33
infologistics,25578,"['info', 'logistics']",2,13,5,8,38.46
crownhotelnaga,25577,"['crown', 'hotel', 'naga']",3,14,5,9,35.71
designmynight,25576,"['design', 'night']",2,13,3,10,23.08
groupsendgateway,25557,"['groups', 'end', 'gateway']",3,16,6,10,37.5
reverse-euskaltel,25524,"['reverse', 'euskal', 'tel']",3,17,7,10,41.18
anfarc-aslani,25523,"['farc', 'aslan']",2,13,5,8,38.46
spin-city-casino,25496,"['spin', 'city', 'casino']",3,16,5,11,31.25
schooladminonline,25446,"['school', 'admin', 'online']",3,17,7,10,41.18
borsinoimmobiliare,25398,"['orsino', 'obili', 'are']",3,18,9,9,50.0
cultural-brokers,25365,"['cultural', 'brokers']",2,16,5,11,31.25
ontariocahotel,25358,"['ontario', 'hotel']",2,14,7,7,50.0
linda-secrets,25338,"['linda', 'secrets']",2,13,4,9,30.77
securehostedemail,25326,"['secure', 'hosted', 'email']",3,17,8,9,47.06
oneminutesite,25317,"['one', 'minute', 'site']",3,13,7,6,53.85
playtechmobile,25315,"['play', 'tech', 'mobile']",3,14,5,9,35.71
budapesthotelsandrates,25293,"['budapest', 'hotels', 'and', 'rates']",4,22,8,14,36.36
feiyangchuangke,25271,"['feiyan', 'chuang']",2,15,6,9,40.0
watercolorinspiration,25212,"['watercolor', 'inspiration']",2,21,9,12,42.86
klclogistics-jm,25200,['logistics'],1,15,3,12,20.0
thearteofmotivation,25134,"['the', 'arte', 'motivation']",3,19,9,10,47.37
netcorporation,25117,"['net', 'corporation']",2,14,6,8,42.86
mercedes-benz,25106,"['mercedes', 'benz']",2,13,4,9,30.77
autumnlanewebsites,25062,"['autumn', 'lane', 'websites']",3,18,8,10,44.44
costadelsol-hotels,25032,"['costa', 'del', 'sol', 'hotels']",4,18,6,12,33.33
shanghaicityhotels,25011,"['shanghai', 'city', 'hotels']",3,18,6,12,33.33
beehivebroadband,25002,"['beehive', 'broadband']",2,16,7,9,43.75
tierarztpraxis-pape-eckmann,24984,"['tier', 'praxis', 'pape', 'eck', 'mann']",5,27,9,18,33.33
newhomesnorthdallas,24981,"['new', 'homes', 'north', 'dallas']",4,19,6,13,31.58
hospitalscenter,24954,"['hospitals', 'center']",2,15,5,10,33.33
topnotchhosting,24945,"['top', 'notch', 'hosting']",3,15,4,11,26.67
superhisecure,24944,"['super', 'secure']",2,13,6,7,46.15
onlineorderingsecure,24915,"['online', 'ordering', 'secure']",3,20,9,11,45.0
earncryptosaj786,24912,"['earn', 'crypto', 'saj', '786']",4,16,4,12,25.0
tireappointment,24876,"['tire', 'appointment']",2,15,6,9,40.0
festmenyvetel,24868,"['fest', 'men', 'tel']",3,13,4,9,30.77
costablanca-hotels,24858,"['costa', 'blanca', 'hotels']",3,18,6,12,33.33
weloveshopping,24847,"['love', 'shopping']",2,14,5,9,35.71
phinternacional,24788,['internacional'],1,15,6,9,40.0
innovateoregon,24771,"['innovate', 'oregon']",2,14,7,7,50.0
beauty-career,24750,"['beauty', 'career']",2,13,6,7,46.15
doesphotography,24740,"['does', 'photography']",2,15,5,10,33.33
flying-antenna,24687,"['flying', 'antenna']",2,14,4,10,28.57
getpaid90dollarpersurvey,24677,"['get', 'paid', 'dollar', 'per', 'survey']",5,24,8,16,33.33
stoppayingrentamerica,24663,"['stop', 'paying', 'rent', 'america']",4,21,8,13,38.1
acorntelevillages,24660,"['acorn', 'tele', 'villages']",3,17,7,10,41.18
ens-paris-saclay,24658,"['ens', 'paris', 'clay']",3,16,5,11,31.25
islandonlakeconroe,24640,"['island', 'lake', 'con', 'roe']",4,18,8,10,44.44
proctergamble,24630,"['procter', 'gamble']",2,13,4,9,30.77
emarketing-mail,24603,"['marketing', 'mail']",2,15,6,9,40.0
electronicamartinez,24566,"['electronica', 'martinez']",2,19,8,11,42.11
99windowbroken,24564,"['window', 'broken']",2,14,4,10,28.57
feitianfengyun,24508,"['fei', 'tian', 'feng', 'yun']",4,14,6,8,42.86
centre-dassistance,24495,"['centre', 'assistance']",2,18,6,12,33.33
teamware-gmbh,24481,"['team', 'ware', 'gmbh']",3,13,4,9,30.77
guestybookings,24481,"['guest', 'bookings']",2,14,5,9,35.71
coucou-networks,24480,"['cou', 'cou', 'networks']",3,15,6,9,40.0
activadvantage,24468,"['act', 'advantage']",2,14,6,8,42.86
rioplexwireless,24462,"['rio', 'plex', 'wireless']",3,15,6,9,40.0
codegenerator,24437,"['code', 'generator']",2,13,6,7,46.15
dobsontechnologies,24431,"['dobson', 'technologies']",2,18,7,11,38.89
los-angeles-metropolitan-area,24401,"['los', 'angeles', 'metropolitan', 'area']",4,29,12,17,41.38
martijnvandezuidwind,24399,"['marti', 'vande', 'zuid', 'wind']",4,20,7,13,35.0
gtecablemodem,24387,"['cable', 'modem']",2,13,5,8,38.46
linn-ky-hth-000,24384,"['linn', '000']",2,15,1,14,6.67
hotel-istanbul,24350,"['hotel', 'istanbul']",2,14,5,9,35.71
superfasthome,24338,"['super', 'fast', 'home']",3,13,5,8,38.46
adultcammoney,24338,"['adult', 'cam', 'money']",3,13,5,8,38.46
zinsen-beim-tagesgeld-1,24331,"['sen', 'beim', 'ages', 'geld']",4,23,7,16,30.43
mybigcommerce,24294,"['big', 'commerce']",2,13,4,9,30.77
ciboperanimali,24257,"['oper', 'animal']",2,14,7,7,50.0
servidoresdns,24246,"['ser', 'vid', 'ores', 'dns']",4,13,4,9,30.77
seoulhotelsdeals,24219,"['seoul', 'hotels', 'deals']",3,16,7,9,43.75
hotelsinvictoria,24192,"['hotels', 'victoria']",2,16,7,9,43.75
bestellen-winkel,24189,"['best', 'ellen', 'winkel']",3,16,5,11,31.25
directorioforuns,24177,"['director', 'runs']",2,16,7,9,43.75
adam-interiors,24165,"['adam', 'interiors']",2,14,6,8,42.86
populargreeting,24156,"['popular', 'greeting']",2,15,6,9,40.0
wtccommunications,24129,"['wtc', 'communications']",2,17,6,11,35.29
top-hotels-es,24114,"['top', 'hotels']",2,13,4,9,30.77
temporarywebsiteaddress,24095,"['temporary', 'website', 'address']",3,23,8,15,34.78
jamesonbiggins,24085,"['jameson', 'big', 'gins']",3,14,5,9,35.71
newageautocover,24076,"['new', 'age', 'auto', 'cover']",4,15,8,7,53.33
instagramvideodownload,24064,"['insta', 'gram', 'video', 'download']",4,22,9,13,40.91
theconversionpros,24050,"['the', 'conversion', 'pros']",3,17,6,11,35.29
clarityenhanced,24036,"['clarity', 'enhanced']",2,15,5,10,33.33
creteislandhotels,24022,"['crete', 'island', 'hotels']",3,17,6,11,35.29
lauraandbrett,23978,"['laura', 'and', 'brett']",3,13,5,8,38.46
sexstories-free,23958,"['sex', 'stories', 'free']",3,15,6,9,40.0
illinoisproperty,23938,"['illinois', 'property']",2,16,6,10,37.5
gtmg-lmydgaogig,23938,"['gao', 'gig']",2,15,3,12,20.0
webstoreplace,23919,"['webs', 'replace']",2,13,5,8,38.46
comparehotelsprague,23895,"['compare', 'hotels', 'prague']",3,19,8,11,42.11
nttlikedomains4,23892,"['ntt', 'like', 'domains']",3,15,5,10,33.33
pethealthnetworkpro,23886,"['pet', 'health', 'network', 'pro']",4,19,6,13,31.58
newportmarketplace,23868,"['newport', 'marketplace']",2,18,6,12,33.33
lolclassifieds,23856,"['lol', 'classifieds']",2,14,5,9,35.71
unisonnetworks,23855,"['unison', 'networks']",2,14,5,9,35.71
blacklabelescort,23850,"['black', 'label', 'escort']",3,16,5,11,31.25
lunanode-rdns,23799,"['luna', 'node', 'rdns']",3,13,4,9,30.77
ucsfmedicalcenter,23798,"['medical', 'center']",2,17,6,11,35.29
tinyhoodreview,23797,"['tiny', 'hood', 'review']",3,14,6,8,42.86
erospornlinks,23790,"['eros', 'porn', 'links']",3,13,4,9,30.77
dotinternetbd,23745,"['dot', 'internet']",2,13,4,9,30.77
longxinglawyer,23742,"['long', 'xing', 'lawyer']",3,14,4,10,28.57
computecanada,23715,"['compute', 'canada']",2,13,6,7,46.15
goodview-digital,23712,"['good', 'view', 'digital']",3,16,7,9,43.75
artistwebsites,23654,"['artist', 'websites']",2,14,5,9,35.71
sportsarefree,23634,"['sports', 'are', 'free']",3,13,5,8,38.46
stadtplanschweiz,23625,"['stadt', 'plan', 'schweiz']",3,16,4,12,25.0
pilotwycieczek,23619,"['pilot', 'ycie']",2,14,5,9,35.71
thepriceproject,23612,"['the', 'price', 'project']",3,15,5,10,33.33
hotelslondon24,23598,"['hotels', 'london']",2,14,4,10,28.57
hotels-apulia,23577,"['hotels', 'apulia']",2,13,6,7,46.15
blackequipment,23554,"['black', 'equipment']",2,14,5,9,35.71
ahwebsolutions,23504,"['web', 'solutions']",2,14,6,8,42.86
wishpondpages,23499,"['wish', 'pond', 'pages']",3,13,4,9,30.77
yangzhilianmeng,23495,"['yang', 'zhi', 'lian', 'meng']",4,15,5,10,33.33
londonhotelsgb,23458,"['london', 'hotels']",2,14,4,10,28.57
breedbanddelft,23451,"['breed', 'band', 'delft']",3,14,4,10,28.57
stagcontentstackapps,23448,"['stag', 'content', 'stack', 'apps']",4,20,5,15,25.0
hotels-rajasthan,23412,"['hotels', 'rajasthan']",2,16,5,11,31.25
localhottestchicks,23402,"['local', 'hottest', 'chicks']",3,18,5,13,27.78
premium-mobile,23392,"['premium', 'mobile']",2,14,6,8,42.86
londonhotelsuk,23361,"['london', 'hotels']",2,14,5,9,35.71
ournewsletters,23358,"['our', 'newsletters']",2,14,5,9,35.71
salesforceliveagent,23350,"['sales', 'force', 'live', 'agent']",4,19,8,11,42.11
marketinginnovators,23346,"['marketing', 'innovators']",2,19,7,12,36.84
icbrock-asfize,23342,"['brock', 'ize']",2,14,5,9,35.71
kuwait-airways,23304,"['kuwait', 'airways']",2,14,6,8,42.86
weshareonline,23283,"['share', 'online']",2,13,6,7,46.15
hosted-by-mvps,23269,"['hosted', 'mvps']",2,14,2,12,14.29
vista-express,23267,"['vista', 'express']",2,13,4,9,30.77
jurassicparkdom,23233,"['jurassic', 'park', 'dom']",3,15,5,10,33.33
bluezonejordan,23216,"['blue', 'zone', 'jordan']",3,14,6,8,42.86
fool-workroom,23175,"['fool', 'work', 'room']",3,13,5,8,38.46
northcarolina-hotels,23148,"['north', 'carolina', 'hotels']",3,20,7,13,35.0
sedelectronica,23143,"['sed', 'electronica']",2,14,6,8,42.86
stz-rechnereinsatz,23076,"['chner', 'atz']",2,18,5,13,27.78
unixcolocation,23043,"['unix', 'location']",2,14,7,7,50.0
customfoodproducts,22956,"['custom', 'food', 'products']",3,18,6,12,33.33
xn--74-6kcaja7faupb6i,22936,['caj'],1,21,5,16,23.81
vrajanandpara,22896,"['rajan', 'and', 'para']",3,13,5,8,38.46
sportingpulse,22882,"['sporting', 'pulse']",2,13,4,9,30.77
tietoverkkopalvelut,22839,"['tie', 'over', 'opal', 'vel']",4,19,8,11,42.11
polskiestronyinternetowe,22716,"['polski', 'estro', 'internet', 'owe']",4,24,9,15,37.5
reputationdefender,22701,"['reputation', 'defender']",2,18,8,10,44.44
versanetonline,22686,"['versa', 'net', 'online']",3,14,6,8,42.86
effectiveperformancenetwork,22684,"['effective', 'performance', 'network']",3,27,10,17,37.04
hotelsoftennessee,22677,"['hotels', 'tennessee']",2,17,7,10,41.18
britishcolumbiahotels,22667,"['british', 'columbia', 'hotels']",3,21,8,13,38.1
fivethreeperspective,22656,"['five', 'three', 'perspective']",3,20,8,12,40.0
cloudcommercepro,22612,"['cloud', 'commerce', 'pro']",3,16,6,10,37.5
yongkangdental,22590,"['yong', 'kang', 'dental']",3,14,4,10,28.57
seaps-membrane,22584,"['seap', 'membrane']",2,14,5,9,35.71
eventinvenice,22579,"['event', 'venice']",2,13,6,7,46.15
wansan-microchip,22566,"['wans', 'microchip']",2,16,5,11,31.25
municipalimpact,22523,"['municipal', 'impact']",2,15,6,9,40.0
aliansoftware,22442,"['alian', 'software']",2,13,6,7,46.15
vigrxplusretailers,22395,"['plus', 'retailers']",2,18,6,12,33.33
webtropia-customer,22394,"['web', 'tro', 'pia', 'customer']",4,18,7,11,38.89
belovedfestival,22362,"['beloved', 'festival']",2,15,6,9,40.0
perimetercenter,22329,"['perimeter', 'center']",2,15,6,9,40.0
matthewleffler,22296,"['matthew', 'ler']",2,14,4,10,28.57
adstshirtwomens,22289,"['dst', 'shirt', 'womens']",3,15,4,11,26.67
citizenxpress,22284,"['citizen', 'xpress']",2,13,4,9,30.77
smartonlineorder,22268,"['smart', 'online', 'order']",3,16,6,10,37.5
changliplastic,22220,"['chang', 'plastic']",2,14,4,10,28.57
bangkokshotels,22218,"['bangkok', 'hotels']",2,14,4,10,28.57
dongxinggufen,22210,"['dong', 'xing', 'fen']",3,13,4,9,30.77
reversenumbertracker,22182,"['reverse', 'number', 'tracker']",3,20,7,13,35.0
joyehinternational,22168,"['joy', 'international']",2,18,8,10,44.44
advis-internal,22152,"['adv', 'internal']",2,14,5,9,35.71
herstellerkatalog,22140,"['her', 'steller', 'kata', 'log']",4,17,6,11,35.29
carmen-hernandez,22128,"['carmen', 'hernandez']",2,16,5,11,31.25
guangzhoutophotels,22098,"['guangzhou', 'top', 'hotels']",3,18,7,11,38.89
hotels-antalya,22068,"['hotels', 'antalya']",2,14,5,9,35.71
vrnjackabanjahoteli,22041,"['jacka', 'banja', 'hotel']",3,19,7,12,36.84
newhouse-tomsk,22027,"['new', 'house', 'tomsk']",3,14,5,9,35.71
swaincrosscountry,22022,"['swain', 'crosscountry']",2,17,5,12,29.41
deleted-domain,22019,"['deleted', 'domain']",2,14,6,8,42.86
sokobanjaprivatnismestaj,22018,"['banja', 'privat', 'mes', 'taj']",4,24,9,15,37.5
heartlandrealestate,22003,"['heartland', 'real', 'estate']",3,19,8,11,42.11
geniuscapital,21984,"['genius', 'capital']",2,13,6,7,46.15
satoriacademynj,21982,"['tori', 'academy']",2,15,6,9,40.0
xn--hemlngtan-y2a,21981,['ngt'],1,17,3,14,17.65
nocturnestudios,21979,"['nocturne', 'studios']",2,15,6,9,40.0
germanshepherdhandbook,21975,"['german', 'shepherd', 'handbook']",3,22,7,15,31.82
ultrabookonline,21973,"['ultra', 'book', 'online']",3,15,7,8,46.67
mastertopforum,21971,"['master', 'top', 'forum']",3,14,5,9,35.71
businessattorneyorangecountyca,21943,"['business', 'attorney', 'orange', 'county']",4,30,12,18,40.0
hotels-in-tyrol,21933,"['hotels', 'tyrol']",2,15,4,11,26.67
perspektivakam,21933,"['per', 'pek', 'vak']",3,14,5,9,35.71
rockymountainvapor,21927,"['rocky', 'mountain', 'vapor']",3,18,7,11,38.89
patternorpractice,21916,"['pattern', 'practice']",2,17,6,11,35.29
marylandrealestatewholesalers,21903,"['maryland', 'real', 'estate', 'wholesalers']",4,29,11,18,37.93
thedatarecoverycenter,21893,"['the', 'data', 'recovery', 'center']",4,21,8,13,38.1
stopsmokingsupport,21892,"['stop', 'smoking', 'support']",3,18,5,13,27.78
struttinginstyle,21890,"['strutting', 'style']",2,16,4,12,25.0
hotpointenterprise,21887,"['hot', 'point', 'enterprise']",3,18,7,11,38.89
partyhitsmusic,21887,"['party', 'hits', 'music']",3,14,4,10,28.57
pediatricdentalva,21880,"['pediatric', 'dental']",2,17,7,10,41.18
forcedmaturemovies,21878,"['forced', 'mature', 'movies']",3,18,8,10,44.44
sokobanjasmestaj,21877,"['banja', 'mes', 'taj']",3,16,6,10,37.5
crosscheckcatahoulas,21875,"['crosscheck', 'cat', 'hou', 'las']",4,20,7,13,35.0
gimutaowebsolutions,21873,"['gim', 'tao', 'web', 'solutions']",4,19,9,10,47.37
lovellacountry,21870,"['lovell', 'country']",2,14,5,9,35.71
hotels-beijing-ch,21867,"['hotels', 'beijing']",2,17,5,12,29.41
occasionalist,21867,"['occasion', 'list']",2,13,6,7,46.15
annuaireboutiqueenligne,21866,"['aire', 'bouti', 'queen', 'lig']",4,23,13,10,56.52
successinayearcoaching,21859,"['success', 'year', 'coaching']",3,22,9,13,40.91
interviewtips,21856,"['interview', 'tips']",2,13,5,8,38.46
creativechurchguys,21855,"['creative', 'church', 'guys']",3,18,6,12,33.33
legendallstarcheer,21853,"['legend', 'all', 'star', 'cheer']",4,18,6,12,33.33
plymouthcreate,21852,"['plymouth', 'create']",2,14,5,9,35.71
livingvertical,21849,"['living', 'vertical']",2,14,5,9,35.71
magictouchbeautystudio,21845,"['magic', 'touch', 'beauty', 'studio']",4,22,10,12,45.45
newcars-prices,21843,"['new', 'cars', 'prices']",3,14,4,10,28.57
stcroixbeachmassage,21843,"['croix', 'beach', 'massage']",3,19,7,12,36.84
shjimeiguanye,21842,"['jim', 'igua', 'nye']",3,13,6,7,46.15
thaitabletennis,21842,"['thai', 'table', 'tennis']",3,15,6,9,40.0
katedanse-bordeaux,21837,"['kate', 'danse', 'bordeaux']",3,18,8,10,44.44
unlockproject,21837,"['unlock', 'project']",2,13,4,9,30.77
raulalejandromartinez,21835,"['raul', 'alejandro', 'martinez']",3,21,9,12,42.86
newmarketbattlefieldmilitarymuseum,21833,"['newmarket', 'battlefield', 'military', 'museum']",4,34,13,21,38.24
artbywhoisandrea,21833,"['art', 'who', 'andrea']",3,16,6,10,37.5
avap-eliquide,21831,"['ava', 'liquid']",2,13,7,6,53.85
chiangmaisilverware,21827,"['chiang', 'mai', 'silverware']",3,19,8,11,42.11
therapeuticcraftcreativity,21819,"['therapeutic', 'craft', 'creativity']",3,26,10,16,38.46
boycomponents,21818,"['boy', 'components']",2,13,4,9,30.77
thehelpsgroup,21817,"['the', 'helps', 'group']",3,13,4,9,30.77
emergelimitada,21816,"['emerge', 'limit', 'ada']",3,14,7,7,50.0
cartoonporndelight,21814,"['cartoon', 'porn', 'delight']",3,18,6,12,33.33
bluedrivingacademy,21814,"['blue', 'driving', 'academy']",3,18,7,11,38.89
twosistersandamister,21811,"['two', 'sisters', 'and', 'mister']",4,20,7,13,35.0
melissagossmakeup,21809,"['melissa', 'goss', 'makeup']",3,17,7,10,41.18
surplus-schoolsbaltimore,21808,"['surplus', 'schools', 'baltimore']",3,24,8,16,33.33
mindbodyequilibrium,21802,"['mind', 'body', 'equilibrium']",3,19,8,11,42.11
americanwarriorcombatives,21796,"['american', 'warrior', 'combative']",3,25,11,14,44.0
restauranteuncastello,21787,"['restaurant', 'eun', 'castello']",3,21,9,12,42.86
creatingcapital,21787,"['creating', 'capital']",2,15,6,9,40.0
coffeemachineeu,21787,"['coffee', 'machine']",2,15,8,7,53.33
fastboywebsite,21783,"['fast', 'boy', 'website']",3,14,5,9,35.71
socialimpactsoftware,21780,"['social', 'impact', 'software']",3,20,8,12,40.0
huaxiazhendao,21780,"['hua', 'xia', 'zhen', 'dao']",4,13,7,6,53.85
mindenkilapja,21774,"['mind', 'enki', 'lap']",3,13,5,8,38.46
star30nailspa,21773,"['star', 'nails']",2,13,4,9,30.77
vrnjackabanjaprivatnismestaj,21771,"['jacka', 'banja', 'privat', 'mes', 'taj']",5,28,9,19,32.14
gonzobrothers,21771,"['gonzo', 'brothers']",2,13,4,9,30.77
dadswoodcrafting,21771,"['dads', 'wood', 'crafting']",3,16,5,11,31.25
yorktownjewishcenter,21771,"['yorktown', 'jewish', 'center']",3,20,6,14,30.0
classicpicturesphotography,21771,"['classic', 'pictures', 'photography']",3,26,8,18,30.77
borderstationpress,21769,"['border', 'station', 'press']",3,18,6,12,33.33
findjobforyou,21769,"['find', 'job', 'for', 'you']",4,13,5,8,38.46
apitours-bali,21766,"['api', 'tours', 'bali']",3,13,6,7,46.15
4ontarioplace,21766,"['ontario', 'place']",2,13,6,7,46.15
canterburycommons,21766,"['canterbury', 'commons']",2,17,5,12,29.41
top-affiliation,21765,"['top', 'affiliation']",2,15,7,8,46.67
drbarbrapayne,21762,"['barbra', 'payne']",2,13,4,9,30.77
thelacemakerssweatshopuk,21757,"['the', 'lace', 'makers', 'sweatshop']",4,24,9,15,37.5
achildsrefuge,21756,"['childs', 'refuge']",2,13,5,8,38.46
goodthingsproduction,21756,"['good', 'things', 'production']",3,20,7,13,35.0
baffapipinganddraincleaning,21755,"['ffa', 'piping', 'and', 'drain', 'cleaning']",5,27,10,17,37.04
wellworldofficial,21754,"['well', 'world', 'official']",3,17,6,11,35.29
albertabenavidesartista,21748,"['alberta', 'navi', 'des', 'artista']",4,23,10,13,43.48
circlechomealert,21744,"['circle', 'home', 'alert']",3,16,6,10,37.5
peppermillcasino,21741,"['pepper', 'mill', 'casino']",3,16,6,10,37.5
buyusedtrucksonline,21740,"['buy', 'used', 'trucks', 'online']",4,19,7,12,36.84
sokobanjahoteli,21737,"['banja', 'hotel']",2,15,7,8,46.67
popularlauren,21736,"['popular', 'lauren']",2,13,6,7,46.15
codefordetroit,21736,"['code', 'for', 'detroit']",3,14,6,8,42.86
womenofhopkins,21736,"['women', 'hopkins']",2,14,5,9,35.71
proba-tarhely,21734,"['pro', 'tar']",2,13,4,9,30.77
marketingartgallery,21731,"['marketing', 'art', 'gallery']",3,19,6,13,31.58
samanthagrier,21729,"['samantha', 'grier']",2,13,5,8,38.46
brunocarmenisjudoblog,21729,"['bruno', 'carmen', 'judo', 'blog']",4,21,8,13,38.1
ebcboxeldersd,21725,"['ebc', 'box', 'elders']",3,13,4,9,30.77
concentricmachine,21723,"['concentric', 'machine']",2,17,6,11,35.29
writerightwrite,21721,"['write', 'right', 'write']",3,15,5,10,33.33
raftingkampovi,21719,"['rafting', 'kam', 'pov']",3,14,5,9,35.71
aussiewineguy,21718,"['aussie', 'wine', 'guy']",3,13,7,6,53.85
attorneycarlcollinsiii,21717,"['attorney', 'carl', 'collins', 'iii']",4,22,9,13,40.91
susanprendina,21717,"['susan', 'end']",2,13,5,8,38.46
cydiainstallerdownload,21716,"['cydia', 'installer', 'download']",3,22,8,14,36.36
juanahernandezconesa,21715,"['juana', 'hernandez', 'cones']",3,20,9,11,45.0
fenstersaugertest,21714,"['nster', 'auger', 'test']",3,17,6,11,35.29
domesticstaff,21713,"['domestic', 'staff']",2,13,4,9,30.77
montereycountypoa,21710,"['monterey', 'county', 'poa']",3,17,7,10,41.18
chidbeachresort,21707,"['chid', 'beach', 'resort']",3,15,5,10,33.33
packingmachinechina,21704,"['packing', 'machine', 'china']",3,19,7,12,36.84
vegantreasurehunter,21704,"['vegan', 'treasure', 'hunter']",3,19,8,11,42.11
survivingseminary,21703,"['surviving', 'seminary']",2,17,6,11,35.29
saranathanspopshop,21702,"['sara', 'nathans', 'pop', 'shop']",4,18,6,12,33.33
artyounggallery,21702,"['art', 'young', 'gallery']",3,15,5,10,33.33
heimatchalets,21699,"['heimat', 'chalets']",2,13,5,8,38.46
artistsabroadhk,21695,"['artists', 'abroad']",2,15,5,10,33.33
basswatergrill,21694,"['bass', 'water', 'grill']",3,14,4,10,28.57
getcartoonporn,21694,"['get', 'cartoon', 'porn']",3,14,5,9,35.71
thebrisbaneavmedcentre,21693,"['the', 'brisbane', 'med', 'centre']",4,22,8,14,36.36
rtdnorthmetro,21693,"['north', 'metro']",2,13,3,10,23.08
safeacnetreatment,21686,"['safe', 'acne', 'treatment']",3,17,7,10,41.18
vg-salzwedel-land,21684,"['salzwedel', 'land']",2,17,4,13,23.53
fujianmingcha,21681,"['fujian', 'ming', 'cha']",3,13,5,8,38.46
windlasssales,21677,"['windlass', 'sales']",2,13,4,9,30.77
gratiscreditcard,21677,"['gratis', 'credit', 'card']",3,16,5,11,31.25
ducemixkitchen,21677,"['duce', 'mix', 'kitchen']",3,14,5,9,35.71
stikescirebon,21672,"['tike', 'sci', 'reb']",3,13,5,8,38.46
madisonengineeringps,21668,"['madison', 'engineering']",2,20,8,12,40.0
waterfordnursinghome,21668,"['waterford', 'nursing', 'home']",3,20,7,13,35.0
theburliesnyc,21666,"['the', 'bur', 'lies', 'nyc']",4,13,4,9,30.77
carpetwashingequipments,21665,"['carpet', 'washing', 'equipments']",3,23,8,15,34.78
happymothersday2014poems,21652,"['happy', 'mothers', 'day', '2014', 'poems']",5,24,6,18,25.0
witchcraftmoonspells,21652,"['witchcraft', 'moonspell']",2,20,5,15,25.0
forbetterforless,21645,"['for', 'better', 'for', 'less']",4,16,5,11,31.25
burnslikefiremusic,21645,"['burns', 'like', 'fire', 'music']",4,18,7,11,38.89
dorthealstrup,21644,"['dort', 'heals']",2,13,4,9,30.77
sourcearchive,21636,"['source', 'archive']",2,13,6,7,46.15
dynatrace-managed,21624,"['dyna', 'trace', 'managed']",3,17,6,11,35.29
noagendatorrents,21623,"['agenda', 'torrents']",2,16,6,10,37.5
camillawhittington,21622,"['camilla', 'whittington']",2,18,6,12,33.33
plascapcorporation,21618,"['ascap', 'corporation']",2,18,7,11,38.89
travelingtechie,21615,"['traveling', 'tech']",2,15,6,9,40.0
appraiserxsites,21612,"['appraiser', 'sites']",2,15,6,9,40.0
thaiexotictreasures,21607,"['thai', 'exotic', 'treasures']",3,19,9,10,47.37
eatlovegarlic,21607,"['eat', 'love', 'garlic']",3,13,6,7,46.15
liftinguhigher,21606,"['lifting', 'higher']",2,14,5,9,35.71
healthstorylines,21591,"['health', 'storylines']",2,16,5,11,31.25
lisbongreathotels,21579,"['lisbon', 'great', 'hotels']",3,17,6,11,35.29
totalcargoexpress,21576,"['total', 'cargo', 'express']",3,17,6,11,35.29
interiorbarndoorshq,21560,"['interior', 'barn', 'doors']",3,19,7,12,36.84
lobovoesteklo,21513,"['lobo', 'voest']",2,13,6,7,46.15
mediziner-test,21513,"['medi', 'zine', 'test']",3,14,5,9,35.71
toptanerkekgiyim,21498,"['top', 'taner']",2,16,6,10,37.5
globalsources,21485,"['global', 'sources']",2,13,5,8,38.46
vasistas-magazine,21480,"['vas', 'magazine']",2,17,7,10,41.18
backlink-counter,21468,"['backlink', 'counter']",2,16,5,11,31.25
lotusdigitalgroup,21456,"['lotus', 'digital', 'group']",3,17,7,10,41.18
africandreamadventuresafaris,21450,"['african', 'dream', 'adventure', 'safaris']",4,28,12,16,42.86
brightdayloans,21438,"['bright', 'day', 'loans']",3,14,4,10,28.57
nagoyafusionbrooklyn,21438,"['nagoya', 'fusion', 'brooklyn']",3,20,8,12,40.0
getusermanuals,21438,"['get', 'user', 'manuals']",3,14,6,8,42.86
thailandbeads,21432,"['thailand', 'beads']",2,13,5,8,38.46
genesisfortlee,21432,"['genesis', 'fort', 'lee']",3,14,6,8,42.86
blendedbabies,21420,"['blended', 'babies']",2,13,5,8,38.46
openshiftapps,21413,"['open', 'shift', 'apps']",3,13,4,9,30.77
adultere-rencontre,21404,"['adult', 'ere', 'ren', 'contre']",4,18,7,11,38.89
uniquelyyoursbypearl,21390,"['uniquely', 'yours', 'pearl']",3,20,8,12,40.0
creditvermittlung,21387,"['credit', 'ver', 'mitt', 'lung']",4,17,5,12,29.41
secure-primarysite,21381,"['secure', 'primary', 'site']",3,18,7,11,38.89
soaringfromwithin,21378,"['soaring', 'from', 'within']",3,17,6,11,35.29
justsharedthis,21375,"['just', 'shared', 'this']",3,14,4,10,28.57
zz-technology,21372,['technology'],1,13,3,10,23.08
informixchina,21372,"['for', 'mix', 'china']",3,13,5,8,38.46
wellmatchhealth,21360,"['well', 'match', 'health']",3,15,4,11,26.67
st-bonifatius-wittmund,21360,"['bon', 'ius', 'witt', 'und']",4,22,7,15,31.82
happy-beautyshop,21342,"['happy', 'beauty', 'shop']",3,16,5,11,31.25
bitcoinfaucethub,21324,"['bitcoin', 'faucet', 'hub']",3,16,7,9,43.75
seoulhotelspage,21309,"['seoul', 'hotels', 'page']",3,15,7,8,46.67
allhotelsillinois,21306,"['all', 'hotels', 'illinois']",3,17,7,10,41.18
mallorcahotelsweb,21297,"['mallorca', 'hotels', 'web']",3,17,6,11,35.29
digitalentrance,21265,"['digital', 'entrance']",2,15,6,9,40.0
robson-eilers,21198,"['robson', 'ler']",2,13,5,8,38.46
hotels-italian-riviera,21177,"['hotels', 'italian', 'riviera']",3,22,10,12,45.45
thelookoutapp,21171,"['the', 'lookout', 'app']",3,13,6,7,46.15
raspberryhosting,21151,"['raspberry', 'hosting']",2,16,4,12,25.0
tes-engineering,21128,"['tes', 'engineering']",2,15,6,9,40.0
patientsanctuary,21114,"['patient', 'sanctuary']",2,16,6,10,37.5
beautyinsider-secrets,21099,"['beauty', 'insider', 'secrets']",3,21,8,13,38.1
jiankangjianggan,21098,"['jian', 'kang', 'jiang', 'gan']",4,16,6,10,37.5
luanpingshijiyiyuan,21093,"['ping', 'shiji', 'yuan']",3,19,8,11,42.11
closetcandyboutique,21087,"['closet', 'candy', 'boutique']",3,19,8,11,42.11
servitesteirl,21059,"['servite', 'ste', 'irl']",3,13,5,8,38.46
huanglingshangwu,21049,"['huang', 'ling', 'shang']",3,16,5,11,31.25
csmolecularimaging,21014,"['molecular', 'imaging']",2,18,7,11,38.89
danjiangzhongxue,21007,"['dan', 'jiang', 'zhong', 'xue']",4,16,6,10,37.5
advanceprotocol,20924,"['advance', 'protocol']",2,15,6,9,40.0
wonderlabkids,20882,"['wonder', 'lab', 'kids']",3,13,4,9,30.77
mensnewspaper,20868,"['mens', 'newspaper']",2,13,4,9,30.77
xn----9sbbbpi8a9bt6f,20865,"['sbb', 'bpi']",2,20,2,18,10.0
aloepsychology,20856,"['aloe', 'psychology']",2,14,5,9,35.71
hotelsinamalficoast,20856,"['hotels', 'mal', 'coast']",3,19,8,11,42.11
rappelz-ancient,20849,"['appel', 'ancient']",2,15,5,10,33.33
servercatalog,20841,"['server', 'catalog']",2,13,5,8,38.46
allcycladeshotels,20826,"['all', 'cyclades', 'hotels']",3,17,5,12,29.41
xcoachoutletonline,20822,"['coach', 'outlet', 'online']",3,18,8,10,44.44
waiqiangban123,20814,"['wai', 'qiang', 'ban', '123']",4,14,5,9,35.71
gammanetworking,20799,"['gamma', 'networking']",2,15,5,10,33.33
onlineeducation,20798,"['online', 'education']",2,15,8,7,53.33
advisertechnology,20772,"['adviser', 'technology']",2,17,6,11,35.29
brautmode-brautmoden,20769,"['aut', 'mode', 'bra', 'utm', 'oden']",5,20,8,12,40.0
weatherproofblanket,20730,"['weatherproof', 'blanket']",2,19,7,12,36.84
thechildrenshospital,20715,"['the', 'childrens', 'hospital']",3,20,6,14,30.0
cloudflarestream,20705,"['cloud', 'flare', 'stream']",3,16,6,10,37.5
yuliiaseliutina,20687,"['yul', 'liut']",2,15,9,6,60.0
chinainfoseek,20684,"['china', 'info', 'seek']",3,13,6,7,46.15
weddingwindow,20676,"['wedding', 'window']",2,13,4,9,30.77
xizanglvxingshe,20667,"['xizang', 'xing', 'she']",3,15,4,11,26.67
bristolinvestment,20664,"['bristol', 'investment']",2,17,5,12,29.41
changshuishanzhuang,20660,"['chang', 'huish', 'zhuang']",3,19,6,13,31.58
alkogold2022new,20652,"['gold', '2022', 'new']",3,15,4,11,26.67
laonianshenghuo,20643,"['laon', 'ian', 'sheng', 'huo']",4,15,7,8,46.67
beijinghotelchina,20598,"['beijing', 'hotel', 'china']",3,17,7,10,41.18
textileconnoisseuraccessorise,20592,"['textile', 'connoisseur', 'access']",3,29,13,16,44.83
hotels-quintana-roo,20580,"['hotels', 'quintana', 'roo']",3,19,8,11,42.11
guoshumiaoweb,20575,"['guo', 'shu', 'miao', 'web']",4,13,7,6,53.85
apartmentscondosfinder,20565,"['apartments', 'condos', 'finder']",3,22,7,15,31.82
prague-hotels,20549,"['prague', 'hotels']",2,13,5,8,38.46
workplacesolutions,20535,"['workplace', 'solutions']",2,18,7,11,38.89
hotels-saudi-arabia,20523,"['hotels', 'saudi', 'arabia']",3,19,9,10,47.37
andrew-stephanie,20517,"['andrew', 'stephanie']",2,16,6,10,37.5
djintelligence,20517,['intelligence'],1,14,5,9,35.71
china-zhengwei,20511,"['china', 'zheng', 'wei']",3,14,5,9,35.71
elitepreviews,20503,"['elite', 'previews']",2,13,6,7,46.15
dinheiroganharplus,20496,"['rogan', 'har', 'plus']",3,18,7,11,38.89
partnerconsole,20491,"['partner', 'console']",2,14,5,9,35.71
toprevenuecpmnetwork,20490,"['top', 'revenue', 'network']",3,20,7,13,35.0
guangyue-lace,20475,"['guang', 'yue', 'lace']",3,13,6,7,46.15
mandyscandals,20466,"['mandy', 'scandals']",2,13,3,10,23.08
kupit-monopod-prosto,20454,"['mono', 'pod', 'pros']",3,20,7,13,35.0
sataireacondicionado,20450,"['aire', 'cond', 'ici']",3,20,11,9,55.0
separategroup,20450,"['separate', 'group']",2,13,6,7,46.15
allkeralahotels,20448,"['all', 'kerala', 'hotels']",3,15,6,9,40.0
hotels-myrtle-beach,20439,"['hotels', 'myrtle', 'beach']",3,19,5,14,26.32
kueche-und-raum,20430,"['und', 'rau']",2,15,6,9,40.0
wlsrenzaocaoping,20403,"['ren', 'zao', 'cao', 'ping']",4,16,6,10,37.5
badcreditloantactics,20400,"['bad', 'credit', 'loan', 'tactics']",4,20,7,13,35.0
healthyhome21,20395,"['healthy', 'home']",2,13,4,9,30.77
hotelbcn-barcelona,20388,"['hotel', 'barcelona']",2,18,6,12,33.33
zhengzhongchou,20382,"['zheng', 'zhong', 'chou']",3,14,4,10,28.57
yngreenlandhotel,20377,"['greenland', 'hotel']",2,16,5,11,31.25
varsityhousegym,20355,"['varsity', 'house', 'gym']",3,15,5,10,33.33
hanzhangzhendao,20335,"['han', 'zhang', 'zhen', 'dao']",4,15,5,10,33.33
thepiratefilmeshd,20335,"['the', 'pirate', 'film']",3,17,6,11,35.29
kosmetikasalon,20330,"['kos', 'met', 'ika', 'salon']",4,14,6,8,42.86
mobilevikings,20324,"['mobile', 'vikings']",2,13,5,8,38.46
manchesterhotelstoday,20311,"['manchester', 'hotels', 'today']",3,21,7,14,33.33
easyrencontre,20309,"['easy', 'ren', 'contre']",3,13,5,8,38.46
trademarklawyerdenver,20304,"['trademark', 'lawyer', 'denver']",3,21,7,14,33.33
devcontentstackapps,20298,"['dev', 'content', 'stack', 'apps']",4,19,5,14,26.32
standardbroadband,20288,"['standard', 'broadband']",2,17,5,12,29.41
belivethirart,20232,"['belive', 'thir', 'art']",3,13,5,8,38.46
easy-speaker-online,20232,"['easy', 'speaker', 'online']",3,19,8,11,42.11
goa-india-hotels-resorts,20232,"['india', 'hotels', 'resorts']",3,24,9,15,37.5
nightmarestresser,20226,"['nightmare', 'stress']",2,17,5,12,29.41
websitewelcome,20217,"['website', 'welcome']",2,14,6,8,42.86
gcmediavormgeving,20201,"['media', 'vor', 'ving']",3,17,6,11,35.29
orlandohotelinfo,20196,"['orlando', 'hotel', 'info']",3,16,7,9,43.75
adventistchurch,20189,"['adventist', 'church']",2,15,4,11,26.67
donedealwebsite,20184,"['done', 'deal', 'website']",3,15,7,8,46.67
pacificpeonies,20172,"['pacific', 'peonies']",2,14,7,7,50.0
adyghe-language,20163,"['adyghe', 'language']",2,15,6,9,40.0
awesomewebspace,20160,"['awesome', 'web', 'space']",3,15,7,8,46.67
activebuilding,20157,"['active', 'building']",2,14,6,8,42.86
live-work-play,20157,"['live', 'work', 'play']",3,14,4,10,28.57
yorkshire-hotel,20151,"['yorkshire', 'hotel']",2,15,5,10,33.33
profitablegatecpm,20140,"['profitable', 'gate']",2,17,6,11,35.29
cjspecialists,20126,['specialists'],1,13,4,9,30.77
securitytrader,20123,"['security', 'trader']",2,14,5,9,35.71
cpmnetworkcontent,20100,"['network', 'content']",2,17,4,13,23.53
hotels-balearic-islands,20079,"['hotels', 'balearic', 'islands']",3,23,8,15,34.78
switchboardcms,20059,"['switchboard', 'cms']",2,14,3,11,21.43
purplemanager,20030,"['purple', 'manager']",2,13,5,8,38.46
sexcams-secrets,20028,"['sex', 'cams', 'secrets']",3,15,4,11,26.67
websitetoolbox,19985,"['website', 'toolbox']",2,14,6,8,42.86
directtvlivestream,19980,"['direct', 'live', 'stream']",3,18,6,12,33.33
reachoneinternet,19980,"['reach', 'one', 'internet']",3,16,7,9,43.75
360medicalbill,19968,"['360', 'medical', 'bill']",3,14,4,10,28.57
myreturnscenter,19958,"['returns', 'center']",2,15,4,11,26.67
moscow-hotels,19953,"['moscow', 'hotels']",2,13,4,9,30.77
telnaptelecom,19932,"['tel', 'nap', 'telecom']",3,13,5,8,38.46
kompaskreditov,19932,"['kom', 'pas', 'edit']",3,14,5,9,35.71
ses-broadband,19927,"['ses', 'broadband']",2,13,4,9,30.77
kc-advertising,19896,['advertising'],1,14,4,10,28.57
performancetop,19887,"['performance', 'top']",2,14,5,9,35.71
artedosminitrucks,19884,"['arte', 'dos', 'mini', 'trucks']",4,17,6,11,35.29
consumer-opinions,19867,"['consumer', 'opinions']",2,17,7,10,41.18
suec-dacor-codab,19842,"['sue', 'dac', 'dab']",3,16,6,10,37.5
digital-product,19840,"['digital', 'product']",2,15,5,10,33.33
regaloespeciales,19823,"['regal', 'special']",2,16,8,8,50.0
secserverpros,19806,"['sec', 'server', 'pros']",3,13,4,9,30.77
quantec-systems,19803,"['quant', 'systems']",2,15,4,11,26.67
adventistchurchconnect,19783,"['adventist', 'church', 'connect']",3,22,6,16,27.27
bloomingdalecom,19776,"['blooming', 'dale', 'com']",3,15,6,9,40.0
shuanglongmenye,19762,"['huang', 'longmen']",2,15,5,10,33.33
trusted-boilers,19749,"['trusted', 'boilers']",2,15,5,10,33.33
personalpages,19745,"['personal', 'pages']",2,13,5,8,38.46
fastcloudsite,19731,"['fast', 'cloud', 'site']",3,13,5,8,38.46
armageddononline,19711,"['armageddon', 'online']",2,16,7,9,43.75
agentmarketing,19710,"['agent', 'marketing']",2,14,5,9,35.71
lovelyvalentinesfinder,19701,"['lovely', 'valentines', 'finder']",3,22,8,14,36.36
helainetreitmantango,19692,"['laine', 'reitman', 'tango']",3,20,9,11,45.0
kocaeliservisim,19682,"['kocaeli', 'ser', 'sim']",3,15,7,8,46.67
penisdirectory,19671,"['penis', 'directory']",2,14,5,9,35.71
therehabprogram,19668,"['the', 'rehab', 'program']",3,15,5,10,33.33
besthotelsohio,19662,"['best', 'hotels', 'ohio']",3,14,6,8,42.86
baldwincountyinternet,19657,"['baldwin', 'county', 'internet']",3,21,7,14,33.33
texas-gulf-coast,19656,"['texas', 'gulf', 'coast']",3,16,5,11,31.25
besteoverzicht,19653,"['best', 'over']",2,14,5,9,35.71
antispamcloud,19647,"['anti', 'spam', 'cloud']",3,13,5,8,38.46
landscapingeasyway,19608,"['landscaping', 'easy', 'way']",3,18,6,12,33.33
emailcupomdesconto,19596,"['email', 'cup', 'desc']",3,18,8,10,44.44
bedrockventure,19585,"['bedrock', 'venture']",2,14,5,9,35.71
cleanenergyvc,19574,"['clean', 'energy']",2,13,4,9,30.77
hotelsalgarve,19571,"['hotels', 'algarve']",2,13,5,8,38.46
school-10-pkgo,19571,['school'],1,14,3,11,21.43
ecomstagingenv,19569,"['com', 'staging']",2,14,5,9,35.71
eadplataforma,19567,"['ead', 'plata', 'form']",3,13,6,7,46.15
barcelonahotelreview,19563,"['barcelona', 'hotel', 'review']",3,20,9,11,45.0
mozer-holdings,19559,"['mozer', 'holdings']",2,14,4,10,28.57
hotels-in-mallorca,19557,"['hotels', 'mallorca']",2,18,6,12,33.33
hotelsofnorway,19533,"['hotels', 'norway']",2,14,5,9,35.71
oracleemaildelivery,19513,"['oracle', 'email', 'delivery']",3,19,9,10,47.37
panel-fiveheberg,19512,"['panel', 'five', 'berg']",3,16,6,10,37.5
baiduxinwenyuan,19510,"['baidu', 'wen', 'yuan']",3,15,7,8,46.67
brandbuilding,19505,"['brand', 'building']",2,13,4,9,30.77
parapercentangle,19478,"['para', 'percent', 'angle']",3,16,6,10,37.5
frobbsthailand,19476,"['robb', 'thailand']",2,14,4,10,28.57
monaco-telecom,19466,"['monaco', 'telecom']",2,14,6,8,42.86
qualitymedicalsouth,19452,"['quality', 'medical', 'south']",3,19,8,11,42.11
thecomicseries,19431,"['the', 'comic', 'series']",3,14,6,8,42.86
contactsenior,19425,"['contact', 'senior']",2,13,5,8,38.46
xiaodiaoche123,19422,"['xiao', 'diao', 'che', '123']",4,14,7,7,50.0
forkliftsamerica,19316,"['forklifts', 'america']",2,16,6,10,37.5
netlifyglobalcdn,19310,"['net', 'global']",2,16,4,12,25.0
intermediasud,19308,"['intermedia', 'sud']",2,13,6,7,46.15
top-hotels-sardinia,19302,"['top', 'hotels', 'sardinia']",3,19,7,12,36.84
akamaiedge-staging,19299,"['kama', 'edge', 'staging']",3,18,8,10,44.44
hairlossprotocol101,19296,"['hair', 'loss', 'protocol', '101']",4,19,6,13,31.58
hotels-in-venice,19293,"['hotels', 'venice']",2,16,6,10,37.5
literatumonline,19288,"['liter', 'atum', 'online']",3,15,7,8,46.67
evebeautyclinic,19269,"['eve', 'beauty', 'clinic']",3,15,7,8,46.67
cloudfunctions,19267,"['cloud', 'functions']",2,14,5,9,35.71
andersonmotors,19247,"['anderson', 'motors']",2,14,5,9,35.71
bootsstoreengland,19226,"['boots', 'store', 'england']",3,17,6,11,35.29
trackingmystats,19179,"['tracking', 'stats']",2,15,3,12,20.0
bangkokthaihotels,19177,"['bangkok', 'thai', 'hotels']",3,17,6,11,35.29
seoul-hotels-kr,19176,"['seoul', 'hotels']",2,15,5,10,33.33
247handbagage,19170,"['247', 'handbag', 'age']",3,13,4,9,30.77
com-officialsite,19164,"['com', 'official', 'site']",3,16,7,9,43.75
novorosinform,19152,"['novo', 'rosin', 'form']",3,13,5,8,38.46
starwarscommand,19151,"['star', 'wars', 'command']",3,15,4,11,26.67
buysellsearch,19149,"['buy', 'sell', 'search']",3,13,4,9,30.77
bubaoheshuzhi,19148,"['bao', 'shu', 'zhi']",3,13,6,7,46.15
kdfashionjewelry,19145,"['fashion', 'jewelry']",2,16,5,11,31.25
simplifycloudlab,19140,"['simplify', 'cloud', 'lab']",3,16,5,11,31.25
cirrusplatform,19086,"['cirrus', 'platform']",2,14,4,10,28.57
dcentertainmentabq,19059,['entertainment'],1,18,6,12,33.33
southwindplantation,19059,"['south', 'wind', 'plantation']",3,19,7,12,36.84
brodiecompanies,19059,"['bro', 'die', 'companies']",3,15,7,8,46.67
topusefulinfo,19056,"['top', 'useful', 'info']",3,13,6,7,46.15
nightbreezeentertainment,19046,"['night', 'breeze', 'entertainment']",3,24,9,15,37.5
marseillanimmobilier,19029,"['mars', 'ill', 'anim', 'mobil']",4,20,9,11,45.0
healthhomedevice,19026,"['health', 'home', 'device']",3,16,7,9,43.75
vegaslocalbars,18996,"['vegas', 'local', 'bars']",3,14,5,9,35.71
piquantslutsfinder,18990,"['piquant', 'sluts', 'finder']",3,18,6,12,33.33
piquantchicksfinder,18990,"['piquant', 'chicks', 'finder']",3,19,6,13,31.58
yummyflingsfinder,18990,"['yummy', 'flings', 'finder']",3,17,4,13,23.53
yummyloversfinder,18990,"['yummy', 'lovers', 'finder']",3,17,5,12,29.41
piquantplaymatesfinder,18990,"['piquant', 'playmates', 'finder']",3,22,8,14,36.36
china-marble-granite,18980,"['china', 'marble', 'granite']",3,20,7,13,35.0
uni-duesseldorf,18971,"['uni', 'due', 'sseldorf']",3,15,6,9,40.0
sweetwaterhsa,18965,['sweetwater'],1,13,5,8,38.46
costumers-kings,18955,"['costume', 'kings']",2,15,4,11,26.67
rolexwatchshoesshop,18888,"['rolex', 'watch', 'shoes', 'shop']",4,19,6,13,31.58
reliancebanking,18884,"['reliance', 'banking']",2,15,6,9,40.0
jensentennisacademy,18864,"['jensen', 'tennis', 'academy']",3,19,7,12,36.84
vizitinekortele,18855,"['viz', 'tele']",2,15,7,8,46.67
smcofficesuites,18854,"['smc', 'office', 'suites']",3,15,6,9,40.0
newjerseykennelsforsale,18851,"['new', 'jersey', 'kennels', 'for', 'sale']",5,23,8,15,34.78
prodeconstructie,18843,"['pro', 'deconstruct']",2,16,6,10,37.5
shuimusheying,18825,"['shui', 'mush', 'eying']",3,13,5,8,38.46
katesdoghouse,18804,"['kate', 'doghouse']",2,13,6,7,46.15
sunsationaltans,18804,"['suns', 'ional', 'tans']",3,15,6,9,40.0
parishotelinn,18802,"['paris', 'hotel', 'inn']",3,13,5,8,38.46
musiclivehouse,18792,"['music', 'live', 'house']",3,14,7,7,50.0
massachusetts-top-hotels,18780,"['massachusetts', 'top', 'hotels']",3,24,7,17,29.17
dezhouhongyue,18769,"['zhou', 'hong', 'yue']",3,13,6,7,46.15
totalticketing,18759,"['total', 'ticketing']",2,14,5,9,35.71
reonbroadband,18756,['broadband'],1,13,5,8,38.46
piggybackblogs,18750,"['piggyback', 'blogs']",2,14,3,11,21.43
sakaryakombiservisi,18728,"['sak', 'arya', 'kom', 'rvis']",4,19,8,11,42.11
webpagefxstage,18727,"['webpage', 'stage']",2,14,5,9,35.71
flywheelsites,18723,"['flywheel', 'sites']",2,13,4,9,30.77
eatwisconsincheese,18702,"['eat', 'wisconsin', 'cheese']",3,18,8,10,44.44
hn-adventures,18696,['adventures'],1,13,4,9,30.77
virginiabesthotels,18696,"['virginia', 'best', 'hotels']",3,18,7,11,38.89
kaiyuezhidai2008,18644,"['kai', 'yuezhi', 'dai', '2008']",4,16,7,9,43.75
kenefickranch,18624,"['ken', 'ick', 'ranch']",3,13,4,9,30.77
liveauctiongroup,18614,"['live', 'auction', 'group']",3,16,8,8,50.0
betaimprimerie,18611,"['beta', 'prime', 'rie']",3,14,7,7,50.0
hairsalonsdir,18607,"['hair', 'salons', 'dir']",3,13,5,8,38.46
intertrade-msk,18591,"['inter', 'trade']",2,14,4,10,28.57
getyourrayban,18576,"['get', 'your', 'ray', 'ban']",4,13,5,8,38.46
mallorca-vive,18564,"['mallorca', 'vive']",2,13,5,8,38.46
travel-warnings,18561,"['travel', 'warnings']",2,15,4,11,26.67
pdiskshortner,18560,"['disk', 'short', 'ner']",3,13,3,10,23.08
serverspeople,18558,"['servers', 'people']",2,13,5,8,38.46
herrmann-von-der-alb,18540,"['herrmann', 'von', 'der', 'alb']",4,20,5,15,25.0
apolloroofingfortworth,18540,"['apollo', 'roofing', 'fort', 'worth']",4,22,8,14,36.36
jiangxiancheng,18527,"['jiangxi', 'cheng']",2,14,5,9,35.71
idealnastrona,18501,"['ideal', 'astron']",2,13,6,7,46.15
homereviewonline,18501,"['home', 'review', 'online']",3,16,8,8,50.0
avtoproblem-net,18495,"['problem', 'net']",2,15,5,10,33.33
homeawayfromhome,18493,"['home', 'away', 'from', 'home']",4,16,7,9,43.75
sunrisetravels,18484,"['sunrise', 'travels']",2,14,5,9,35.71
stage-ngrok-free,18465,"['stage', 'rok', 'free']",3,16,5,11,31.25
judoo-raymond,18450,"['judo', 'raymond']",2,13,5,8,38.46
kvartersmenyn,18449,"['art', 'ers', 'men']",3,13,3,10,23.08
zhongyuanylchang,18444,"['zhong', 'yuan', 'chang']",3,16,4,12,25.0
hotel-in-valencia,18384,"['hotel', 'valencia']",2,17,7,10,41.18
simpleconnector,18372,"['simple', 'connector']",2,15,5,10,33.33
tvknaszapraca,18366,"['zap', 'rac']",2,13,4,9,30.77
agencyanalytics,18361,"['agency', 'analytics']",2,15,5,10,33.33
vermeermidsouth,18350,"['vermeer', 'mid', 'south']",3,15,6,9,40.0
trusted-extensions,18336,"['trusted', 'extensions']",2,18,6,12,33.33
livesexchatclub,18333,"['live', 'sex', 'chat', 'club']",4,15,5,10,33.33
globalrustrade,18324,"['global', 'rus', 'trade']",3,14,5,9,35.71
thetemplatedemo,18321,"['the', 'template', 'demo']",3,15,6,9,40.0
rejestracjadomen,18312,"['jest', 'rac', 'men']",3,16,6,10,37.5
monentreprise,18306,"['mon', 'entrep', 'rise']",3,13,5,8,38.46
harpmortgagelender,18300,"['harp', 'mortgage', 'lender']",3,18,6,12,33.33
reversemortgageamerica,18288,"['reverse', 'mortgage', 'america']",3,22,10,12,45.45
vaguaranteedhomeloans,18288,"['guaranteed', 'home', 'loans']",3,21,10,11,47.62
foreverliving,18280,"['forever', 'living']",2,13,5,8,38.46
conceptshopping,18270,"['concept', 'shopping']",2,15,4,11,26.67
earthlovesall,18264,"['earth', 'loves', 'all']",3,13,5,8,38.46
capturebroadband,18230,"['capture', 'broadband']",2,16,6,10,37.5
dcphilippines,18228,['philippines'],1,13,4,9,30.77
book-onlinenow,18218,"['book', 'online', 'now']",3,14,6,8,42.86
fangtewangguo,18216,"['fang', 'wang', 'guo']",3,13,5,8,38.46
online-staging,18207,"['online', 'staging']",2,14,5,9,35.71
china-direct-buy,18186,"['china', 'direct', 'buy']",3,16,5,11,31.25
crypto-extranet,18185,"['crypto', 'extra', 'net']",3,15,4,11,26.67
mycloudwebsites,18176,"['cloud', 'websites']",2,15,5,10,33.33
hochiminh-top-hotels,18165,"['hoch', 'minh', 'top', 'hotels']",4,20,6,14,30.0
autoteam-plus,18150,"['auto', 'team', 'plus']",3,13,6,7,46.15
thesoccershirts,18149,"['the', 'soccer', 'shirts']",3,15,4,11,26.67
columbusstate,18146,"['columbus', 'state']",2,13,5,8,38.46
traversprinting,18142,"['travers', 'printing']",2,15,4,11,26.67
tokyo-hotels-stay,18135,"['tokyo', 'hotels', 'stay']",3,17,5,12,29.41
fh-reutlingen,18117,['reutlingen'],1,13,4,9,30.77
sisterseductionstories,18099,"['sister', 'seduction', 'stories']",3,22,9,13,40.91
simplyhosting,18096,"['simply', 'hosting']",2,13,3,10,23.08
oldcorralclub,18078,"['old', 'corral', 'club']",3,13,4,9,30.77
legalshieldassociate,18072,"['legal', 'shield', 'associate']",3,20,9,11,45.0
gettopacoustic,18066,"['get', 'top', 'acoustic']",3,14,6,8,42.86
cybernetprovedor,18056,"['cybernet', 'proved']",2,16,5,11,31.25
gorod-sveta-rf,18033,"['rod', 'vet']",2,14,4,10,28.57
mesventespriveesdujour,18024,"['mes', 'vent', 'esp', 'rive', 'jour']",5,22,9,13,40.91
washington-state,18017,"['washington', 'state']",2,16,5,11,31.25
merchandisescheme,18008,"['merchandise', 'scheme']",2,17,6,11,35.29
bestcpmnetwork,18000,"['best', 'network']",2,14,3,11,21.43
rometravelhotel,18000,"['rome', 'travel', 'hotel']",3,15,6,9,40.0
polytechnique,17995,['polytechnique'],1,13,5,8,38.46
gitbook-staging,17991,"['book', 'staging']",2,15,5,10,33.33
timing-spacing,17974,"['timing', 'spacing']",2,14,4,10,28.57
onlinegownshop,17969,"['online', 'gown', 'shop']",3,14,5,9,35.71
walletgallery,17964,"['wallet', 'gallery']",2,13,4,9,30.77
shandongletong,17963,"['shandong', 'tong']",2,14,4,10,28.57
dealerconnection,17936,"['dealer', 'connection']",2,16,7,9,43.75
hotelsofnewyorkcity,17904,"['hotels', 'new', 'york', 'city']",4,19,6,13,31.58
craftingstore,17898,"['crafting', 'store']",2,13,4,9,30.77
associationcareernetwork,17895,"['association', 'career', 'network']",3,24,11,13,45.83
fantasyhostbd,17892,"['fantasy', 'host']",2,13,3,10,23.08
bespokefittedkitchens,17892,"['bespoke', 'fitted', 'kitchens']",3,21,7,14,33.33
websitebiography,17883,"['website', 'biography']",2,16,6,10,37.5
drupalgardens,17874,"['rupal', 'gardens']",2,13,4,9,30.77
toastmastersclubs,17871,"['toastmasters', 'clubs']",2,17,5,12,29.41
egnyte-appliance,17859,"['gny', 'appliance']",2,16,6,10,37.5
churchofchrist,17852,"['church', 'christ']",2,14,3,11,21.43
nelson-medical,17832,"['nelson', 'medical']",2,14,5,9,35.71
nameanameanamea,17831,"['name', 'name', 'name']",3,15,9,6,60.0
albertpaschen,17793,"['albert', 'pas', 'chen']",3,13,4,9,30.77
bluemilenetworks,17790,"['blue', 'mile', 'networks']",3,16,6,10,37.5
postalrecruitment,17772,"['postal', 'recruitment']",2,17,6,11,35.29
livesex-secrets,17766,"['live', 'sex', 'secrets']",3,15,5,10,33.33
fittechsummit,17751,"['fit', 'tech', 'summit']",3,13,4,9,30.77
dallastexashotels,17748,"['dallas', 'texas', 'hotels']",3,17,6,11,35.29
networkmanager,17743,"['network', 'manager']",2,14,5,9,35.71
arubabusiness,17731,"['aruba', 'business']",2,13,6,7,46.15
activenetwork,17726,"['active', 'network']",2,13,5,8,38.46
shitangwangui,17717,"['shit', 'gwan', 'gui']",3,13,5,8,38.46
hotels-in-hochiminh,17696,"['hotels', 'hoch', 'minh']",3,19,6,13,31.58
diamondtradingpost,17690,"['diamond', 'trading', 'post']",3,18,6,12,33.33
createprosite,17688,"['create', 'pro', 'site']",3,13,6,7,46.15
southinstrument,17674,"['south', 'instrument']",2,15,5,10,33.33
chirurgiens-dentistes,17674,"['chi', 'rur', 'gie', 'dentist']",4,21,7,14,33.33
thesupersuper,17655,"['the', 'super', 'super']",3,13,5,8,38.46
siteunblocked,17630,"['site', 'unblocked']",2,13,5,8,38.46
roscoe-jessica,17626,"['roscoe', 'jessica']",2,14,6,8,42.86
superdnsserver,17621,"['super', 'dns', 'server']",3,14,4,10,28.57
digital-studio,17613,"['digital', 'studio']",2,14,6,8,42.86
securewifilogin,17601,"['secure', 'login']",2,15,7,8,46.67
interviewerassistant,17595,"['interviewer', 'assistant']",2,20,8,12,40.0
mystockkeeper,17556,"['stock', 'keeper']",2,13,4,9,30.77
escalahastalacima,17544,"['scala', 'has', 'tal', 'cim']",4,17,8,9,47.06
dmitryraevsky,17534,"['dmitry', 'rae', 'sky']",3,13,3,10,23.08
bigscoots-wpo,17527,"['big', 'scoots']",2,13,4,9,30.77
telindustelecom,17469,"['tel', 'indus', 'telecom']",3,15,6,9,40.0
solutionlivret,17460,"['solution', 'liv', 'ret']",3,14,6,8,42.86
hs-furtwangen,17424,"['furtw', 'gen']",2,13,3,10,23.08
usedvermeertexas,17421,"['used', 'vermeer', 'texas']",3,16,7,9,43.75
onlinefoodgrocery,17409,"['online', 'food', 'grocery']",3,17,7,10,41.18
anyofficesupplies,17395,"['any', 'office', 'supplies']",3,17,7,10,41.18
laurenfrostfit,17371,"['lauren', 'frost', 'fit']",3,14,5,9,35.71
lifttruckmass,17355,"['lift', 'truck', 'mass']",3,13,3,10,23.08
xxxanimations,17352,"['xxx', 'animations']",2,13,5,8,38.46
commonwealthu,17342,['commonwealth'],1,13,5,8,38.46
hotels-canary-islands,17340,"['hotels', 'canary', 'islands']",3,21,6,15,28.57
livegirl-secrets,17340,"['live', 'girl', 'secrets']",3,16,5,11,31.25
videogamedownload,17316,"['videogame', 'download']",2,17,8,9,47.06
hotelsparis24,17307,"['hotels', 'paris']",2,13,4,9,30.77
freeonlinegames,17303,"['free', 'online', 'games']",3,15,7,8,46.67
airinformatics,17300,"['air', 'informatics']",2,14,6,8,42.86
autosearchtech,17298,"['auto', 'search', 'tech']",3,14,6,8,42.86
schoolzineplus,17298,"['school', 'zine', 'plus']",3,14,5,9,35.71
lianhuaxintian,17294,"['lian', 'hua', 'tian']",3,14,7,7,50.0
portraitstorefront,17280,"['portrait', 'storefront']",2,18,6,12,33.33
interdominios,17264,"['inter', 'domini']",2,13,6,7,46.15
leaguelobster,17262,"['league', 'lobster']",2,13,6,7,46.15
dimensionedellavoro,17256,"['dimension', 'edel', 'lav', 'oro']",4,19,9,10,47.37
vermeerrockymountain,17241,"['vermeer', 'rocky', 'mountain']",3,20,8,12,40.0
chiangmai-hotels4u,17238,"['chiang', 'mai', 'hotels']",3,18,7,11,38.89
sigmaingenieria,17215,"['sigma', 'genie', 'ria']",3,15,8,7,53.33
dellcroslamda,17183,"['dell', 'cro', 'lamda']",3,13,4,9,30.77
vikinghostcdn,17181,"['viking', 'host']",2,13,3,10,23.08
websiteregain,17178,"['website', 'regain']",2,13,6,7,46.15
stoplinereport,17163,"['stop', 'line', 'report']",3,14,5,9,35.71
bsl-pvc-panel,17162,"['bsl', 'pvc', 'panel']",3,13,2,11,15.38
massageplanet,17150,"['massage', 'planet']",2,13,5,8,38.46
nimblethimble,17148,"['nimble', 'thimble']",2,13,4,9,30.77
piedmontforklifthandling,17106,"['piedmont', 'forklift', 'handling']",3,24,7,17,29.17
questdiagonistics,17100,"['quest', 'dia', 'gon', 'tics']",4,17,7,10,41.18
santiago-hotels-chile,17073,"['santiago', 'hotels', 'chile']",3,21,8,13,38.1
bengkelhpaceh,17040,"['kel', 'aceh']",2,13,4,9,30.77
quel-couvreur,17035,"['que', 'couvre']",2,13,6,7,46.15
swissbackbone,17015,"['swiss', 'backbone']",2,13,4,9,30.77
titovasvetlana,17010,"['titov', 'svetlana']",2,14,6,8,42.86
hotelsintamilnadu,17004,"['hotels', 'tamilnadu']",2,17,7,10,41.18
wolves-on-hunting,17001,"['wolves', 'hunting']",2,17,5,12,29.41
new-york-city-hotel,16945,"['new', 'york', 'city', 'hotel']",4,19,5,14,26.32
pengjinwenhua,16933,"['peng', 'wen', 'hua']",3,13,5,8,38.46
secure-platform,16932,"['secure', 'platform']",2,15,5,10,33.33
pistenbullyrussia,16928,"['ten', 'bully', 'russia']",3,17,6,11,35.29
exergenglobal,16912,"['exe', 'rgen', 'global']",3,13,5,8,38.46
talkingtotoddlers,16910,"['talking', 'toddlers']",2,17,5,12,29.41
trackingoffer,16896,"['tracking', 'offer']",2,13,4,9,30.77
odumgu-ilothy,16893,"['odu', 'ilo', 'thy']",3,13,5,8,38.46
aerobickleding,16890,"['aerobic', 'kle', 'ding']",3,14,6,8,42.86
andreasgorski,16884,"['andreas', 'gor', 'ski']",3,13,5,8,38.46
alicefuldauer,16872,"['alice', 'fulda']",2,13,7,6,53.85
nickelpayments,16869,"['nickel', 'payments']",2,14,4,10,28.57
powerplustool,16867,"['power', 'plus', 'tool']",3,13,5,8,38.46
deltatelesystems,16863,"['delta', 'tele', 'systems']",3,16,5,11,31.25
iotinactionevents,16860,"['action', 'events']",2,17,8,9,47.06
phoenixasianescorts,16851,"['phoenix', 'asian', 'escorts']",3,19,8,11,42.11
crazyaussiesalervrs,16845,"['crazy', 'aussie', 'sale', 'vrs']",4,19,7,12,36.84
rrtestlandingpage,16845,"['test', 'landing', 'page']",3,17,5,12,29.41
wordjackorange,16840,"['word', 'jack', 'orange']",3,14,5,9,35.71
stadtausstellung,16833,"['stadt', 'uss', 'tel', 'lung']",4,16,5,11,31.25
hosts-fiberone,16833,"['hosts', 'fiber', 'one']",3,14,5,9,35.71
chinasonangol,16816,"['china', 'son', 'gol']",3,13,5,8,38.46
themodernfirm,16804,"['the', 'modern', 'firm']",3,13,4,9,30.77
zalive-akvilon,16800,"['live', 'vil']",2,14,6,8,42.86
secure-decoration,16788,"['secure', 'decoration']",2,17,8,9,47.06
inspirational-world,16780,"['inspirational', 'world']",2,19,7,12,36.84
fumushijian2018,16767,"['shiji', '2018']",2,15,5,10,33.33
tres-adorable,16764,"['tres', 'adorable']",2,13,5,8,38.46
streetartcities,16748,"['street', 'art', 'cities']",3,15,6,9,40.0
lindamodel-exposed,16746,"['linda', 'model', 'exposed']",3,18,7,11,38.89
talentplatforms,16743,"['talent', 'platforms']",2,15,4,11,26.67
sexmodel-secrets,16734,"['sex', 'model', 'secrets']",3,16,5,11,31.25
hotelsmallorca24,16722,"['hotels', 'mallorca']",2,16,5,11,31.25
dev-ngrok-free,16668,"['dev', 'rok', 'free']",3,14,4,10,28.57
sharewarecentral,16659,"['shareware', 'central']",2,16,6,10,37.5
globaldailydealassociation,16644,"['global', 'daily', 'deal', 'association']",4,26,12,14,46.15
china-jlsports,16638,"['china', 'sports']",2,14,3,11,21.43
chuanchengmingyi,16610,"['chuan', 'cheng', 'ming']",3,16,5,11,31.25
szkolnastrona,16608,"['kol', 'astron']",2,13,4,9,30.77
printyourfood,16608,"['print', 'your', 'food']",3,13,5,8,38.46
changqingschool,16596,"['chang', 'qing', 'school']",3,15,4,11,26.67
goodkarmastroy,16593,"['good', 'karmas', 'troy']",3,14,5,9,35.71
miami-metropolitan-area,16581,"['miami', 'metropolitan', 'area']",3,23,11,12,47.83
trackreceptor,16578,"['track', 'receptor']",2,13,4,9,30.77
tracksymphony,16578,"['track', 'symphony']",2,13,2,11,15.38
feministesenmouvements,16575,"['feminist', 'mouvement']",2,22,9,13,40.91
formationsp76,16548,['formations'],1,13,4,9,30.77
healthstation,16543,"['health', 'station']",2,13,5,8,38.46
thetravelagentnextdoor,16539,"['the', 'travel', 'agent', 'next', 'door']",5,22,8,14,36.36
genevageneral,16539,"['geneva', 'general']",2,13,6,7,46.15
kinedo-douche,16527,"['kin', 'edo', 'douche']",3,13,6,7,46.15
irinastarovid,16524,"['irina', 'star', 'ovid']",3,13,6,7,46.15
physicalprofits,16506,"['physical', 'profits']",2,15,4,11,26.67
hsxuanyuanhotel,16499,"['xuan', 'yuan', 'hotel']",3,15,6,9,40.0
sardiniahotels24,16473,"['sardinia', 'hotels']",2,16,6,10,37.5
ginzacontacts,16465,"['ginza', 'contacts']",2,13,4,9,30.77
galerie-creation,16461,"['galerie', 'creation']",2,16,8,8,50.0
onlinehdstream,16435,"['online', 'stream']",2,14,5,9,35.71
paintballfest,16434,"['paintball', 'fest']",2,13,4,9,30.77
centrosantoafonsodeligorio,16428,"['centro', 'santo', 'afonso', 'deli', 'rio']",5,26,12,14,46.15
cognix-systems,16424,"['cog', 'nix', 'systems']",3,14,3,11,21.43
accountservergroup,16409,"['account', 'server', 'group']",3,18,7,11,38.89
gidpokreditam,16407,"['gid', 'pok', 'red']",3,13,5,8,38.46
zgsamanwenhua,16398,"['saman', 'wen', 'hua']",3,13,5,8,38.46
myteachersite,16392,"['teacher', 'site']",2,13,5,8,38.46
outstandingcsa,16392,"['outstanding', 'csa']",2,14,5,9,35.71
petrobaltgroup,16380,"['petro', 'bal', 'group']",3,14,5,9,35.71
gravitational,16376,['gravitational'],1,13,6,7,46.15
roskapitalitiinfo,16344,"['ros', 'kapital', 'info']",3,17,8,9,47.06
liveauctioneers,16324,"['live', 'auctioneers']",2,15,8,7,53.33
istanbulhotels365,16323,"['istanbul', 'hotels', '365']",3,17,5,12,29.41
friendscheers,16313,"['friends', 'cheers']",2,13,4,9,30.77
bogotaenmariachi,16308,"['bogota', 'mariachi']",2,16,8,8,50.0
guangzhouhotelschina,16308,"['guangzhou', 'hotels', 'china']",3,20,8,12,40.0
matthiasschild,16308,"['matthias', 'child']",2,14,4,10,28.57
lumina-previews,16301,"['lumina', 'previews']",2,15,6,9,40.0
pussyreviewed,16296,"['pussy', 'reviewed']",2,13,5,8,38.46
employeemillionare,16296,"['employee', 'million', 'are']",3,18,9,9,50.0
furnitureandme,16296,"['furniture', 'and']",2,14,6,8,42.86
avonrepresentative,16278,"['avon', 'representative']",2,18,8,10,44.44
saloproduction,16260,"['salo', 'production']",2,14,6,8,42.86
empleogenerales,16248,"['emp', 'leo', 'general']",3,15,7,8,46.67
camgirls-secrets,16230,"['cam', 'girls', 'secrets']",3,16,4,12,25.0
contactoparaweb,16221,"['contact', 'para', 'web']",3,15,6,9,40.0
futuretornado,16212,"['future', 'tornado']",2,13,6,7,46.15
libre-algerie,16205,"['libre', 'alger']",2,13,6,7,46.15
opsourcecloud,16203,"['source', 'cloud']",2,13,6,7,46.15
onenightchicksfinder,16200,"['one', 'night', 'chicks', 'finder']",4,20,6,14,30.0
onenightadultsfinder,16200,"['one', 'night', 'adults', 'finder']",4,20,7,13,35.0
petiteladiesfinder,16191,"['petite', 'ladies', 'finder']",3,18,8,10,44.44
juicyloversfinder,16191,"['juicy', 'lovers', 'finder']",3,17,6,11,35.29
letmeshowyoumylove,16191,"['let', 'show', 'you', 'love']",4,18,7,11,38.89
empresasenmexico,16189,"['emp', 'res', 'mexico']",3,16,7,9,43.75
online-server,16183,"['online', 'server']",2,13,5,8,38.46
freedomsailing,16165,"['freedom', 'sailing']",2,14,6,8,42.86
centr-rynokvrn,16158,['cent'],1,14,2,12,14.29
hotelspiedmont,16143,"['hotels', 'piedmont']",2,14,5,9,35.71
teledata-fttx,16134,"['tele', 'data']",2,13,4,9,30.77
yalovaservisi,16096,"['yalova', 'rvis']",2,13,6,7,46.15
xn--777-iddy3ab1byh,16094,"['777', 'idd']",2,19,2,17,10.53
hotels-in-utah,16068,"['hotels', 'utah']",2,14,5,9,35.71
hbgveggiefest,16038,"['veggie', 'fest']",2,13,4,9,30.77
hotels-in-campania,16023,"['hotels', 'campania']",2,18,7,11,38.89
mature-for-you,16023,"['mature', 'for', 'you']",3,14,6,8,42.86
chunuxinghaoyl,16020,"['chun', 'xing', 'hao']",3,14,5,9,35.71
gibolt-bithon,16019,"['bolt', 'bit', 'hon']",3,13,4,9,30.77
livegirls-secrets,15990,"['live', 'girls', 'secrets']",3,17,5,12,29.41
derikl-hokohan,15976,"['erik', 'koh']",2,14,5,9,35.71
allsuratthanihotels,15969,"['all', 'surat', 'than', 'hotels']",4,19,7,12,36.84
samochody-weselne,15965,"['sam', 'ocho', 'wesel']",3,17,6,11,35.29
tokyohoteltour,15965,"['tokyo', 'hotel', 'tour']",3,14,6,8,42.86
verygoodproxy,15956,"['very', 'good', 'proxy']",3,13,4,9,30.77
luckydragonstudio,15949,"['lucky', 'dragon', 'studio']",3,17,6,11,35.29
hotelescotedazur,15939,"['hotel', 'cote', 'azur']",3,16,7,9,43.75
pornblogspace,15939,"['porn', 'blog', 'space']",3,13,4,9,30.77
best-hotels-cannes,15936,"['best', 'hotels', 'cannes']",3,18,5,13,27.78
florence-hotels-it,15933,"['florence', 'hotels']",2,18,6,12,33.33
getthefactshomeinspection,15924,"['get', 'the', 'facts', 'home', 'inspection']",5,25,9,16,36.0
denvergreenjobs,15913,"['denver', 'green', 'jobs']",3,15,5,10,33.33
newbodrumrestaurant,15912,"['new', 'bodrum', 'restaurant']",3,19,7,12,36.84
uchwycone-chwile,15912,"['hwy', 'cone', 'wile']",3,16,5,11,31.25
marketmakerleads,15886,"['market', 'maker', 'leads']",3,16,6,10,37.5
meyer-optik-goerlitz,15885,"['meyer', 'tik', 'goer', 'litz']",4,20,7,13,35.0
himchistka-dom,15883,"['him', 'his', 'tka', 'dom']",4,14,4,10,28.57
homedecorinteriordesigns,15868,"['home', 'decor', 'interior', 'designs']",4,24,10,14,41.67
completeaudioandvideo,15864,"['complete', 'audio', 'and', 'video']",4,21,11,10,52.38
hotelinewyork,15855,"['hotel', 'new', 'york']",3,13,5,8,38.46
extranet-administrateurs,15828,"['extra', 'net', 'administrate', 'urs']",4,24,9,15,37.5
livesexcamsnova,15824,"['live', 'sex', 'cams', 'nova']",4,15,6,9,40.0
instanttraders,15810,"['instant', 'traders']",2,14,4,10,28.57
hotelsbuenosaires,15802,"['hotels', 'buenos', 'aires']",3,17,8,9,47.06
centraleuropetravel,15798,"['central', 'europe', 'travel']",3,19,8,11,42.11
designinfosystem,15792,"['design', 'info', 'system']",3,16,5,11,31.25
elmetodoespanol,15792,['espanol'],1,15,7,8,46.67
myrealestatebusiness,15792,"['real', 'estate', 'business']",3,20,8,12,40.0
duhonmachinery,15789,"['duh', 'machinery']",2,14,5,9,35.71
fithealthblog,15787,"['fit', 'health', 'blog']",3,13,4,9,30.77
tencent-cloud,15760,"['tencent', 'cloud']",2,13,4,9,30.77
disposablecode,15756,"['disposable', 'code']",2,14,6,8,42.86
webdevelopers,15755,"['web', 'developers']",2,13,5,8,38.46
karamurselgokceemlak,15748,"['kara', 'murs', 'eem', 'lak']",4,20,8,12,40.0
modhumotyhaat,15744,"['mod', 'humo']",2,13,5,8,38.46
madridrealhotel,15740,"['madrid', 'real', 'hotel']",3,15,6,9,40.0
restaurantegreenhouse,15739,"['restaurant', 'greenhouse']",2,21,10,11,47.62
aodap-staging,15732,"['oda', 'staging']",2,13,5,8,38.46
empresasclasificadas,15730,"['emp', 'res', 'cad']",3,20,8,12,40.0
allguangzhouhotels,15708,"['all', 'guangzhou', 'hotels']",3,18,7,11,38.89
sonassihosting,15706,"['son', 'hosting']",2,14,5,9,35.71
saasprotection,15701,"['saas', 'protection']",2,14,6,8,42.86
goldclub-mktg,15690,"['gold', 'club', 'mkt']",3,13,2,11,15.38
maketheseasonbright,15687,"['make', 'the', 'season', 'bright']",4,19,7,12,36.84
foreignpolicy,15687,"['foreign', 'policy']",2,13,5,8,38.46
everlastingspa,15667,"['everlasting', 'spa']",2,14,5,9,35.71
polishedplastering,15658,"['polished', 'plastering']",2,18,6,12,33.33
clfford-ortiz,15652,"['clf', 'ford', 'ortiz']",3,13,3,10,23.08
hotelsinsaintpetersburg,15645,"['hotels', 'saint', 'petersburg']",3,23,8,15,34.78
my-gaestebuch,15641,"['este', 'buch']",2,13,4,9,30.77
ibericaderedes,15628,"['rica', 'red']",2,14,7,7,50.0
ho-chi-minh-city-hotels,15627,"['chi', 'minh', 'city', 'hotels']",4,23,6,17,26.09
your-storageshare,15604,"['your', 'storage', 'share']",3,17,7,10,41.18
ofertasespana,15599,"['ert', 'espana']",2,13,6,7,46.15
cangzhourongda,15595,"['can', 'hour', 'gda']",3,14,5,9,35.71
garagenschutz,15588,"['garage', 'schutz']",2,13,4,9,30.77
energy-robotics,15584,"['energy', 'robotics']",2,15,5,10,33.33
cornerstonecellars,15579,"['cornerstone', 'cellars']",2,18,6,12,33.33
nolongeruseddomain,15578,"['longer', 'used', 'domain']",3,18,8,10,44.44
ideasandassociates,15570,"['ideas', 'and', 'associates']",3,18,9,9,50.0
smithvilledigital,15569,"['smith', 'ville', 'digital']",3,17,6,11,35.29
tabapuaradioweb,15555,"['tab', 'apu', 'radio', 'web']",4,15,8,7,53.33
domainedepradejorda,15546,"['domain', 'ede', 'pra', 'jord']",4,19,9,10,47.37
easy-rencontre,15543,"['easy', 'ren', 'contre']",3,14,5,9,35.71
best-dubai-hotels,15540,"['best', 'dubai', 'hotels']",3,17,6,11,35.29
okohan-cevebt,15532,"['koh', 'eve']",2,13,5,8,38.46
freeappraisal,15526,"['free', 'appraisal']",2,13,6,7,46.15
best-hotels-marrakesh,15519,"['best', 'hotels', 'marrakesh']",3,21,6,15,28.57
floridabluemedicate,15516,"['florida', 'blue', 'medicate']",3,19,9,10,47.37
destinyislife,15516,"['destiny', 'life']",2,13,5,8,38.46
mandy-secrets,15516,"['mandy', 'secrets']",2,13,3,10,23.08
pinterestnine,15509,"['interest', 'nine']",2,13,5,8,38.46
easy-rencontres,15486,"['easy', 'ren', 'contre']",3,15,5,10,33.33
inherent-dikti,15471,"['inherent', 'dik']",2,14,5,9,35.71
inspiredcreativetech,15464,"['inspired', 'creative', 'tech']",3,20,8,12,40.0
inboxdelivered,15460,"['box', 'delivered']",2,14,6,8,42.86
bloomblogshop,15456,"['bloom', 'blog', 'shop']",3,13,4,9,30.77
netterfindeva,15450,"['net', 'ter', 'find', 'eva']",4,13,5,8,38.46
tamkeen-installment,15450,"['tam', 'keen', 'installment']",3,19,6,13,31.58
fa-takedrivers,15438,"['take', 'drivers']",2,14,5,9,35.71
ionianislandshotels,15435,"['ionian', 'islands', 'hotels']",3,19,8,11,42.11
your-sponsoring,15432,"['your', 'sponsoring']",2,15,5,10,33.33
webserverhost,15430,"['web', 'server', 'host']",3,13,4,9,30.77
gercop-extranet,15423,"['ger', 'cop', 'extra', 'net']",4,15,5,10,33.33
instantstreaming,15408,"['instant', 'streaming']",2,16,5,11,31.25
netsuperstore,15408,"['net', 'superstore']",2,13,5,8,38.46
download-servicemanual,15399,"['download', 'service', 'manual']",3,22,9,13,40.91
strato-editor-widget,15387,"['strato', 'editor', 'widget']",3,20,7,13,35.0
advocacytools,15368,"['advocacy', 'tools']",2,13,5,8,38.46
revenuecpmnetwork,15330,"['revenue', 'network']",2,17,6,11,35.29
mk-netzdienste,15323,"['net', 'die', 'nste']",3,14,4,10,28.57
turnkeycoachingsolutions,15321,"['turnkey', 'coaching', 'solutions']",3,24,9,15,37.5
hopliteindustries,15316,"['hoplite', 'industries']",2,17,7,10,41.18
chrysalis-its,15315,"['chrysalis', 'its']",2,13,3,10,23.08
beneficiarios,15303,"['bene', 'cia', 'rios']",3,13,7,6,53.85
grab-credit4u,15297,"['grab', 'credit']",2,13,4,9,30.77
appalachianwireless,15297,"['appalachian', 'wireless']",2,19,8,11,42.11
datingwebsite24,15294,"['dating', 'website']",2,15,5,10,33.33
downloadgratis,15292,"['download', 'gratis']",2,14,5,9,35.71
xn--d1abbmkhk2b2a,15287,['abb'],1,17,2,15,11.76
coloringpages24x7,15264,"['coloring', 'pages']",2,17,5,12,29.41
cotedazur-hotels,15246,"['cote', 'azur', 'hotels']",3,16,6,10,37.5
enabledemployment,15216,"['enabled', 'employment']",2,17,6,11,35.29
idrettenonline,15213,"['dre', 'tten', 'online']",3,14,6,8,42.86
bangkoktophotels,15207,"['bangkok', 'top', 'hotels']",3,16,5,11,31.25
baoshiyanshuang,15195,"['bao', 'shi', 'yan', 'huang']",4,15,6,9,40.0
glytecsystems-dev,15189,"['gly', 'tec', 'systems', 'dev']",4,17,3,14,17.65
hotels-newdelhi,15183,"['hotels', 'new', 'delhi']",3,15,5,10,33.33
ereignis-werkstatt,15180,"['reign', 'statt']",2,18,6,12,33.33
speedtestcustom,15170,"['speed', 'test', 'custom']",3,15,5,10,33.33
nicolelombard,15147,"['nicole', 'lombard']",2,13,5,8,38.46
osservaprezzi,15144,"['serva', 'prez']",2,13,5,8,38.46
bankofamerica,15140,"['bank', 'america']",2,13,6,7,46.15
greenteksolutionsllc,15126,"['green', 'tek', 'solutions', 'llc']",4,20,7,13,35.0
time2jailbreak,15119,"['time', 'jailbreak']",2,14,6,8,42.86
clippingbrasil,15118,"['clipping', 'brasil']",2,14,4,10,28.57
robertstruckcenter,15117,"['robert', 'struck', 'center']",3,18,5,13,27.78
northislandnz,15108,"['north', 'island']",2,13,3,10,23.08
bridgeblogging,15106,"['bridge', 'blogging']",2,14,4,10,28.57
thinkcoarsely,15072,"['think', 'coarsely']",2,13,4,9,30.77
wrapupresources,15062,"['wrap', 'resources']",2,15,6,9,40.0
rustcheatcheck,15051,"['rust', 'cheat', 'check']",3,14,4,10,28.57
muabandoanhnghiep,15045,"['bando', 'ngh']",2,17,7,10,41.18
digitaltarget,15044,"['digital', 'target']",2,13,5,8,38.46
fuyingcaipiao14,15025,"['ying', 'ipia']",2,15,7,8,46.67
autodealersdir,15022,"['auto', 'dealers', 'dir']",3,14,7,7,50.0
ccf-logistics,15019,"['ccf', 'logistics']",2,13,3,10,23.08
dcikson-lreoy,15016,"['cik', 'son']",2,13,4,9,30.77
fort-worth-metropolitan-area,15009,"['fort', 'worth', 'metropolitan', 'area']",4,28,10,18,35.71
bodybuildingbolt,15001,"['bodybuilding', 'bolt']",2,16,5,11,31.25
bahnhofs-apotheke,15000,"['bahnhof', 'apo', 'the']",3,17,6,11,35.29
dodchristiansoldiers,14997,"['dod', 'christian', 'soldiers']",3,20,7,13,35.0
suprremeinfotech,14994,"['upr', 'info', 'tech']",3,16,6,10,37.5
panhandle-florida,14982,"['panhandle', 'florida']",2,17,6,11,35.29
venetohotelsweb,14979,"['veneto', 'hotels', 'web']",3,15,6,9,40.0
bestkualalumpurhotels,14970,"['best', 'kuala', 'lumpur', 'hotels']",4,21,8,13,38.1
ooo-medexpress,14967,"['ooo', 'med', 'express']",3,14,6,8,42.86
inabapyonpyon,14964,"['bap', 'yon']",2,13,5,8,38.46
avalon-company,14953,"['avalon', 'company']",2,14,5,9,35.71
integritywokforce,14949,"['integrity', 'wok', 'force']",3,17,6,11,35.29
residentservice,14930,"['resident', 'service']",2,15,6,9,40.0
academiasocial,14917,"['academia', 'social']",2,14,8,6,57.14
radiointegracao,14916,"['radio', 'gra', 'cao']",3,15,8,7,53.33
carros-baratos,14910,"['car', 'ros', 'bara']",3,14,5,9,35.71
musicasromanticas,14901,"['music', 'romantic']",2,17,7,10,41.18
cristianoliveira,14899,"['cristian', 'oliveira']",2,16,8,8,50.0
novotel-events,14898,"['novo', 'tel', 'events']",3,14,5,9,35.71
ken-tennwireless,14891,"['ken', 'tenn', 'wireless']",3,16,5,11,31.25
criarlojavirtual,14889,"['cri', 'arlo', 'virtual']",3,16,7,9,43.75
fireinformatica,14889,"['fire', 'format', 'ica']",3,15,7,8,46.67
criativamente,14888,"['cri', 'men']",2,13,6,7,46.15
jornadadosucesso,14886,"['jorn', 'dado', 'sucess']",3,16,7,9,43.75
amazonvillage,14885,"['amazon', 'village']",2,13,6,7,46.15
fashionsummer,14885,"['fashion', 'summer']",2,13,5,8,38.46
ceramicauniao,14877,"['ceramic', 'uni']",2,13,8,5,61.54
securevetsource,14877,"['secure', 'vet', 'source']",3,15,7,8,46.67
melhor-oferta,14876,"['mel', 'hor', 'ert']",3,13,5,8,38.46
gabrielcarvalho,14875,"['gabriel', 'carvalho']",2,15,6,9,40.0
clienteseguro,14875,"['client', 'ese', 'guro']",3,13,6,7,46.15
tecnologiarfid,14874,"['tecnol', 'ogi', 'rfid']",3,14,6,8,42.86
radionordeste,14873,"['radio', 'nord', 'este']",3,13,6,7,46.15
guiacondominios,14873,"['guia', 'condom', 'ios']",3,15,8,7,53.33
produtonacional,14872,"['pro', 'nacional']",2,15,7,8,46.67
gustavomoraes,14870,"['gustavo', 'moraes']",2,13,6,7,46.15
mundodocelular,14870,"['mundo', 'lula']",2,14,6,8,42.86
siteoficial-br,14869,"['site', 'oficial']",2,14,6,8,42.86
unimedempresarial,14868,"['uni', 'mede', 'res', 'arial']",4,17,8,9,47.06
suaescolhacerta,14868,"['uae', 'col', 'hace', 'rta']",4,15,7,8,46.67
camilaeleandro,14866,"['cami', 'lae', 'leandro']",3,14,7,7,50.0
seducaomodaintima,14864,"['edu', 'cao', 'moda', 'tima']",4,17,9,8,52.94
clubedabeleza,14863,"['club', 'eda', 'lez']",3,13,6,7,46.15
meucurso-online,14863,"['cur', 'online']",2,15,7,8,46.67
menteblindada,14862,"['men', 'blind', 'ada']",3,13,5,8,38.46
trainingacademia,14861,"['training', 'academia']",2,16,8,8,50.0
gigaeletronicos,14859,"['giga', 'ele', 'tronic']",3,15,7,8,46.67
angelovirgilio,14859,"['angelo', 'virgilio']",2,14,7,7,50.0
crescaeapareca,14859,"['cresc', 'are']",2,14,7,7,50.0
agenciaradioweb,14859,"['agencia', 'radio', 'web']",3,15,8,7,53.33
laarquitetura,14858,"['quite', 'tura']",2,13,7,6,53.85
giovannisilva,14856,"['giovanni', 'silva']",2,13,6,7,46.15
anthonycaronia,14856,"['anthony', 'caron']",2,14,6,8,42.86
claudiaribeiro,14856,"['claudia', 'ribeiro']",2,14,8,6,57.14
hranitelnidobavki,14852,"['hra', 'nite', 'ido', 'bav']",4,17,7,10,41.18
endzonebrasil,14851,"['endzone', 'brasil']",2,13,5,8,38.46
alfacorporate,14850,"['alfa', 'corporate']",2,13,6,7,46.15
lucasenatalia,14850,"['lucas', 'natalia']",2,13,7,6,53.85
ricardopinheiro,14850,"['ricardo', 'pinheiro']",2,15,7,8,46.67
cotacaodeseguros,14850,"['taca', 'ode', 'seguros']",3,16,8,8,50.0
harmoniafestas,14850,"['harmonia', 'fest']",2,14,6,8,42.86
mensagemdodia,14847,"['mensa', 'gem', 'dia']",3,13,6,7,46.15
si-informatica,14847,"['format', 'ica']",2,14,6,8,42.86
aventurabrasil,14845,"['aventura', 'brasil']",2,14,6,8,42.86
fernandaemarcos,14845,"['fernanda', 'marcos']",2,15,6,9,40.0
restaurantwebexpert,14844,"['restaurant', 'web', 'expert']",3,19,7,12,36.84
thiagoejessica,14844,"['thiago', 'jessica']",2,14,7,7,50.0
labinvestimentos,14844,"['lab', 'invest', 'men']",3,16,6,10,37.5
historiadafamilia,14844,"['historia', 'familia']",2,17,9,8,52.94
condominiovirtual,14844,"['condom', 'virtual']",2,17,8,9,47.06
magazinenunes,14844,"['magazine', 'nunes']",2,13,6,7,46.15
seocopywriting,14843,"['seo', 'copy', 'writing']",3,14,5,9,35.71
autoescolabrasil,14843,"['auto', 'escola', 'brasil']",3,16,8,8,50.0
maisconsultoria,14843,"['consul', 'tori']",2,15,7,8,46.67
profitsources,14842,"['profit', 'sources']",2,13,5,8,38.46
creativehtml5,14841,"['creative', 'html']",2,13,4,9,30.77
amadorascaseiras,14841,"['amadora', 'case', 'iras']",3,16,8,8,50.0
nataliaeleonardo,14841,"['natalia', 'leonardo']",2,16,9,7,56.25
breakawayidiomas,14841,"['breakaway', 'idiom']",2,16,8,8,50.0
acompanhantespoa,14841,"['com', 'panh', 'antes', 'poa']",4,16,7,9,43.75
igrejaluterana,14841,"['igreja', 'lute', 'rana']",3,14,7,7,50.0
andradedownloads,14841,"['andrade', 'downloads']",2,16,6,10,37.5
calcadosdejau,14841,"['calc', 'dos', 'deja']",3,13,6,7,46.15
consultoriasp,14839,"['consul', 'tori', 'asp']",3,13,5,8,38.46
desenhandoonline,14838,"['sen', 'hand', 'online']",3,16,7,9,43.75
slovakiatrade,14837,"['slovakia', 'trade']",2,13,6,7,46.15
planetscraper,14835,"['planet', 'scraper']",2,13,4,9,30.77
capemisasocial,14835,"['cape', 'misa', 'social']",3,14,7,7,50.0
lojablackshirt,14835,"['black', 'shirt']",2,14,4,10,28.57
favilla-carvalho,14835,"['villa', 'carvalho']",2,16,6,10,37.5
cmvempreiteira,14835,"['vem', 'pre', 'eira']",3,14,6,8,42.86
fotoarteventos,14835,"['foto', 'art', 'even']",3,14,6,8,42.86
alberoniearruda,14835,"['lber', 'arruda']",2,15,8,7,53.33
fazendasaolucas,14835,"['fazenda', 'sao', 'lucas']",3,15,7,8,46.67
navarrosebelmonte,14835,"['navarro', 'belmonte']",2,17,7,10,41.18
braileclinica,14835,"['bra', 'ile', 'clinic']",3,13,6,7,46.15
marmores-coliseum,14835,"['mar', 'more', 'coliseum']",3,17,7,10,41.18
sundanceimaging,14835,"['sundance', 'imaging']",2,15,6,9,40.0
goldimproducoes,14835,"['gold', 'imp', 'rod', 'coe']",4,15,6,9,40.0
downloadwinapps,14835,"['download', 'win', 'apps']",3,15,5,10,33.33
worldventures,14828,"['world', 'ventures']",2,13,4,9,30.77
bestofsalerno,14827,"['best', 'salerno']",2,13,5,8,38.46
mvsuggestions,14816,['suggestions'],1,13,4,9,30.77
pattayahotels-thailand,14808,"['pattaya', 'hotels', 'thailand']",3,22,8,14,36.36
86pearljewelry,14802,"['pearl', 'jewelry']",2,14,4,10,28.57
topprofitablegate,14790,"['top', 'profitable', 'gate']",3,17,7,10,41.18
hotels-in-dubai,14766,"['hotels', 'dubai']",2,15,6,9,40.0
blogging-riches,14739,"['blogging', 'riches']",2,15,4,11,26.67
garrison-ultra-dev,14736,"['garrison', 'ultra', 'dev']",3,18,6,12,33.33
restaurantwebexperts,14727,"['restaurant', 'web', 'experts']",3,20,7,13,35.0
anudhinamanna,14717,"['hina', 'manna']",2,13,6,7,46.15
verhuisbedrijvenvergelijk,14715,"['ver', 'bed', 'rij', 'ven', 'verge']",5,25,9,16,36.0
schildersvergelijk,14715,"['childers', 'verge']",2,18,5,13,27.78
mercuryserver,14715,"['mercury', 'server']",2,13,4,9,30.77
livegirls-news,14712,"['live', 'girls', 'news']",3,14,4,10,28.57
airportmarine,14706,"['airport', 'marine']",2,13,6,7,46.15
hospitalityclub,14701,"['hospitality', 'club']",2,15,5,10,33.33
top-hotels-cy,14699,"['top', 'hotels']",2,13,3,10,23.08
makingyoulive,14685,"['making', 'you', 'live']",3,13,6,7,46.15
michiganbesthotels,14676,"['michigan', 'best', 'hotels']",3,18,6,12,33.33
glowbyteconsulting,14673,"['glow', 'byte', 'consulting']",3,18,5,13,27.78
superiorceramic,14671,"['superior', 'ceramic']",2,15,7,8,46.67
jobsearchsite,14625,"['job', 'search', 'site']",3,13,5,8,38.46
subjectmatter,14610,"['subject', 'matter']",2,13,4,9,30.77
vatelecomservices,14604,"['telecom', 'services']",2,17,7,10,41.18
stepupheight-increaser,14592,"['step', 'height', 'increase']",3,22,8,14,36.36
whitepatronus,14583,"['white', 'patronus']",2,13,5,8,38.46
rk19-bielefeld-mitte,14580,"['bielefeld', 'mitte']",2,20,6,14,30.0
metaverseworld365,14574,"['meta', 'verse', 'world', '365']",4,17,5,12,29.41
kinglineequipment,14571,"['king', 'line', 'equipment']",3,17,7,10,41.18
effectivecpmcontent,14570,"['effective', 'content']",2,19,6,13,31.58
balkoninventaris,14568,"['balk', 'invent', 'aris']",3,16,6,10,37.5
druckerei-leuchtfeuer,14568,"['rucker', 'leu', 'feuer']",3,21,9,12,42.86
bitcoinekspert,14565,"['bitcoin', 'pert']",2,14,5,9,35.71
restaurantsnapshot,14547,"['restaurant', 'snapshot']",2,18,6,12,33.33
giolbt-domasn,14543,['dom'],1,13,4,9,30.77
liveonlinechat,14532,"['live', 'online', 'chat']",3,14,6,8,42.86
samuelsjewelers,14526,"['samuel', 'jewelers']",2,15,6,9,40.0
legislatiamuncii,14526,"['legis', 'lat', 'iam', 'unc']",4,16,8,8,50.0
telecharger360,14512,"['tele', 'charger', '360']",3,14,4,10,28.57
smarthomeprice,14487,"['smart', 'home', 'price']",3,14,5,9,35.71
website-start,14482,"['website', 'start']",2,13,4,9,30.77
nextappointment,14466,"['next', 'appointment']",2,15,5,10,33.33
blachy-rynny-dachy,14460,"['achy', 'achy']",2,18,2,16,11.11
saintpetersburg-hotels,14457,"['saint', 'petersburg', 'hotels']",3,22,7,15,31.82
bierparadies-altdorf,14424,"['bier', 'para', 'dies', 'altdorf']",4,20,8,12,40.0
toutemonecole,14420,"['ute', 'mon', 'ecole']",3,13,7,6,53.85
krystalclearmoments,14400,"['stal', 'clear', 'moments']",3,19,5,14,26.32
hosting-igrovyh-serverov,14400,"['hosting', 'gro', 'server']",3,24,7,17,29.17
digitalmarket,14383,"['digital', 'market']",2,13,5,8,38.46
instantencore,14378,"['instant', 'encore']",2,13,5,8,38.46
immersivelabs,14378,"['mmer', 'sive', 'labs']",3,13,5,8,38.46
deutsche-sk-sachwert,14376,"['deutsche', 'ach', 'wert']",3,20,5,15,25.0
livegirl-news,14364,"['live', 'girl', 'news']",3,13,4,9,30.77
uuhimalayanqm,14364,['himalayan'],1,13,6,7,46.15
registerlifeskills,14352,"['register', 'life', 'skills']",3,18,6,12,33.33
unibw-hamburg,14346,"['uni', 'hamburg']",2,13,4,9,30.77
zespoly-weselne,14346,"['poly', 'wesel']",2,15,5,10,33.33
topvotedrecipes,14340,"['top', 'voted', 'recipes']",3,15,6,9,40.0
businesscentral,14327,"['business', 'central']",2,15,5,10,33.33
worldsportranking,14326,"['world', 'sport', 'ranking']",3,17,4,13,23.53
greaterantilleshotels,14319,"['greater', 'antilles', 'hotels']",3,21,8,13,38.1
salesbootcamp,14317,"['sales', 'boot', 'camp']",3,13,5,8,38.46
passion-angel,14316,"['passion', 'angel']",2,13,5,8,38.46
containership,14310,"['container', 'ship']",2,13,5,8,38.46
globexdesigns,14304,"['globe', 'designs']",2,13,4,9,30.77
tbilisi-hotels,14293,"['tbilisi', 'hotels']",2,14,5,9,35.71
iteamhomeinspections,14286,"['team', 'home', 'inspections']",3,20,9,11,45.0
commercialrealty,14281,"['commercial', 'realty']",2,16,6,10,37.5
uk-logbook-loans,14274,"['logbook', 'loans']",2,16,6,10,37.5
hotelsofphuket,14265,"['hotels', 'phuket']",2,14,5,9,35.71
somersandassociates,14265,"['somers', 'and', 'associates']",3,19,8,11,42.11
westelsystems,14265,"['west', 'systems']",2,13,3,10,23.08
sexmodel-news,14250,"['sex', 'model', 'news']",3,13,4,9,30.77
covenrtyschools,14244,"['coven', 'schools']",2,15,4,11,26.67
live-sex-facts,14238,"['live', 'sex', 'facts']",3,14,4,10,28.57
hirdavatnalburiyeuzmani,14237,"['irda', 'vat', 'nal', 'buri', 'mani']",5,23,10,13,43.48
entcolleges90,14232,"['ent', 'colleges']",2,13,4,9,30.77
apiture-hosting,14208,"['api', 'ture', 'hosting']",3,15,6,9,40.0
guitarchordsntabs,14194,"['guitar', 'chords', 'tabs']",3,17,5,12,29.41
produktyfinansowe,14182,"['prod', 'fin']",2,17,6,11,35.29
proimageblogs,14181,"['pro', 'image', 'blogs']",3,13,5,8,38.46
hackersacademy,14181,"['hackers', 'academy']",2,14,5,9,35.71
altadefinizione,14178,"['alta', 'def', 'one']",3,15,8,7,53.33
whitelabel-hivebrite,14172,"['white', 'label', 'hive', 'brite']",4,20,8,12,40.0
eastcoastflagpole,14168,"['east', 'coast', 'flagpole']",3,17,7,10,41.18
ikonhospitality,14167,"['ikon', 'hospitality']",2,15,6,9,40.0
engine-trouble-code,14162,"['engine', 'trouble', 'code']",3,19,8,11,42.11
hotdealcourse,14160,"['hot', 'deal', 'course']",3,13,6,7,46.15
ziergefluegel,14157,"['flue', 'gel']",2,13,6,7,46.15
debramurraycooking,14156,"['debra', 'murray', 'cooking']",3,18,7,11,38.89
lustypartnersfinder,14148,"['lusty', 'partners', 'finder']",3,19,5,14,26.32
tenderadultsfinder,14148,"['tender', 'adults', 'finder']",3,18,6,12,33.33
eventraevents,14148,"['event', 'events']",2,13,5,8,38.46
royalsuniversity,14144,"['royals', 'university']",2,16,6,10,37.5
freshcookiesonline,14143,"['fresh', 'cookies', 'online']",3,18,8,10,44.44
achieverclubs,14132,"['achiever', 'clubs']",2,13,5,8,38.46
elreydelcotillon,14130,"['rey', 'del', 'tillon']",3,16,6,10,37.5
beautyandcompany,14124,"['beauty', 'and', 'company']",3,16,6,10,37.5
scarlettcamgirls,14118,"['scarlett', 'cam', 'girls']",3,16,4,12,25.0
chambermaster,14111,"['chamber', 'master']",2,13,4,9,30.77
playa-del-carmen-hotel,14103,"['play', 'del', 'carmen', 'hotel']",4,22,7,15,31.82
worldprintech,14099,"['world', 'print', 'ech']",3,13,3,10,23.08
howlandlondon,14096,"['howland', 'london']",2,13,4,9,30.77
szhengbowjpem,14082,"['zheng', 'bow']",2,13,3,10,23.08
astrodatabase,14082,"['astro', 'database']",2,13,6,7,46.15
1-hostingservice,14081,"['hosting', 'service']",2,16,5,11,31.25
mortgagewebcenter,14079,"['mortgage', 'web', 'center']",3,17,6,11,35.29
carolanns-cafe,14076,"['carol', 'ann', 'cafe']",3,14,5,9,35.71
allhotelsinmissouri,14073,"['all', 'hotels', 'missouri']",3,19,8,11,42.11
mighty-pixels,14073,"['mighty', 'pixels']",2,13,3,10,23.08
psdtohtmlhint,14071,"['html', 'hint']",2,13,2,11,15.38
acsitefactory,14067,"['site', 'factory']",2,13,5,8,38.46
10healthyvibes,14064,"['healthy', 'vibes']",2,14,4,10,28.57
guatemalawater,14059,"['guatemala', 'water']",2,14,7,7,50.0
planetary-networks,14048,"['planetary', 'networks']",2,18,5,13,27.78
hanoihotels-online,14040,"['hanoi', 'hotels', 'online']",3,18,8,10,44.44
bestrevenuenetwork,14040,"['best', 'revenue', 'network']",3,18,7,11,38.89
tgpoolservices,14026,"['pool', 'services']",2,14,5,9,35.71
backlinkbooster,14025,"['backlink', 'booster']",2,15,5,10,33.33
eastcoastbanner,14022,"['east', 'coast', 'banner']",3,15,6,9,40.0
chiangmaihotelspage,14019,"['chiang', 'mai', 'hotels', 'page']",4,19,8,11,42.11
midi-pyrenees-hotels,14019,"['midi', 'pyrenees', 'hotels']",3,20,7,13,35.0
marrakesh-great-hotels,14016,"['marrakesh', 'great', 'hotels']",3,22,7,15,31.82
excursionesdiattagambia,14015,"['excursion', 'atta', 'gambia']",3,23,11,12,47.83
laurenkeskinel,14013,"['lauren', 'skin']",2,14,6,8,42.86
suzhouyehuaqi,14012,"['zhou', 'hua']",2,13,7,6,53.85
bangshunsuits,14008,"['bang', 'shun', 'suits']",3,13,4,9,30.77
firestickremote,14007,"['fire', 'stick', 'remote']",3,15,6,9,40.0
wxzhongqimoju,14004,"['zhong', 'moj']",2,13,4,9,30.77
wwwxingaicanting,14001,"['www', 'xing', 'canting']",3,16,5,11,31.25
gc-webhosting,13992,"['web', 'hosting']",2,13,3,10,23.08
carbon-climate,13989,"['carbon', 'climate']",2,14,5,9,35.71
bergen-scottish,13980,"['bergen', 'scottish']",2,15,4,11,26.67
nanbeitomfycdn,13965,"['nan', 'omf']",2,14,4,10,28.57
hotels-in-shenzhen,13962,"['hotels', 'shenzhen']",2,18,5,13,27.78
cryptocurrencywebsites,13960,"['crypto', 'currency', 'websites']",3,22,6,16,27.27
futuraplanete,13957,"['tura', 'planet']",2,13,6,7,46.15
emailcharmingcharlie,13956,"['email', 'charming', 'charlie']",3,20,8,12,40.0
pensacolacoffee,13956,"['pensacola', 'coffee']",2,15,7,8,46.67
pneumatici100,13953,"['pneumatic', '100']",2,13,5,8,38.46
lauraestanford,13943,"['laura', 'stanford']",2,14,6,8,42.86
neumaticos100,13935,"['neum', 'tico', '100']",3,13,5,8,38.46
theteamserver,13928,"['the', 'team', 'server']",3,13,5,8,38.46
childrenscolorado,13918,"['childrens', 'colorado']",2,17,6,11,35.29
spravka-region,13911,"['spr', 'vka', 'region']",3,14,5,9,35.71
flexwebhosting,13906,"['flex', 'web', 'hosting']",3,14,4,10,28.57
mon-demenagement,13903,"['mon', 'menage', 'ment']",3,16,6,10,37.5
hawaii-all-hotels,13890,"['hawaii', 'all', 'hotels']",3,17,7,10,41.18
new-york-hotels-ny,13866,"['new', 'york', 'hotels']",3,18,4,14,22.22
parker-design,13863,"['parker', 'design']",2,13,4,9,30.77
fonciernonbati,13863,"['fon', 'cie', 'bati']",3,14,6,8,42.86
california100,13863,"['california', '100']",2,13,5,8,38.46
sanmarco-sochi,13860,"['san', 'marco', 'sochi']",3,14,5,9,35.71
youandnoother,13857,"['you', 'and', 'other']",3,13,6,7,46.15
smarteventscloud,13853,"['smart', 'events', 'cloud']",3,16,5,11,31.25
barstoolssite,13851,"['bars', 'tools', 'site']",3,13,5,8,38.46
florencehotelitaly,13850,"['florence', 'hotel', 'italy']",3,18,7,11,38.89
tilegroup-inc,13845,"['tile', 'group', 'inc']",3,13,5,8,38.46
bioskinclinic,13838,"['bio', 'skin', 'clinic']",3,13,5,8,38.46
trialnetworks,13828,"['trial', 'networks']",2,13,4,9,30.77
realwebsitesite,13825,"['real', 'website', 'site']",3,15,7,8,46.67
hotelsmarrakech,13812,"['hotels', 'marrakech']",2,15,5,10,33.33
scottsdalewebsitedesign,13807,"['scottsdale', 'website', 'design']",3,23,8,15,34.78
consumerelectronics,13806,"['consumer', 'electronics']",2,19,7,12,36.84
verizonwireless,13802,"['verizon', 'wireless']",2,15,6,9,40.0
cangurosdelaguarda,13800,"['can', 'guro', 'dela', 'guarda']",4,18,8,10,44.44
extract-sweet,13766,"['extract', 'sweet']",2,13,4,9,30.77
ilovecrossbreeds,13757,"['love', 'crossbreeds']",2,16,6,10,37.5
russianrealty,13749,"['russian', 'realty']",2,13,5,8,38.46
citizens-connected,13749,"['citizens', 'connected']",2,18,6,12,33.33
constructiondir,13740,"['construction', 'dir']",2,15,5,10,33.33
elitecustomcontractors,13737,"['elite', 'custom', 'contractors']",3,22,8,14,36.36
logopedonline,13728,"['logo', 'ped', 'online']",3,13,6,7,46.15
topkavsupport,13704,"['pka', 'support']",2,13,4,9,30.77
tophotelsparis,13704,"['top', 'hotels', 'paris']",3,14,5,9,35.71
matrixconsulting,13693,"['matrix', 'consulting']",2,16,5,11,31.25
privateladiesfinder,13689,"['private', 'ladies', 'finder']",3,19,8,11,42.11
hkserverdomain,13686,"['server', 'domain']",2,14,5,9,35.71
ferienhaus-kassner,13680,"['rien', 'haus', 'kass', 'ner']",4,18,7,11,38.89
lastebilsider,13677,"['last', 'bil', 'side']",3,13,5,8,38.46
teamworkprogram,13677,"['teamwork', 'program']",2,15,5,10,33.33
bestbuenosaireshotels,13674,"['best', 'buenos', 'aires', 'hotels']",4,21,9,12,42.86
commentkonfait,13652,"['comment', 'kon', 'fait']",3,14,5,9,35.71
isabellalowengrip,13650,"['isabella', 'low', 'grip']",3,17,7,10,41.18
bayerischestaferl,13647,"['bayerische', 'tafe']",2,17,6,11,35.29
differentialfluidexchange,13644,"['differential', 'fluid', 'exchange']",3,25,10,15,40.0
allvisayashotels,13644,"['all', 'visayas', 'hotels']",3,16,6,10,37.5
developerakademie,13641,"['developer', 'akademie']",2,17,9,8,52.94
linksuggestie,13639,"['link', 'suggest']",2,13,5,8,38.46
yoursuperstores,13632,"['your', 'superstore']",2,15,6,9,40.0
malmoiloveyou,13625,"['malmo', 'iloveyou']",2,13,7,6,53.85
likehuntsville,13622,"['like', 'huntsville']",2,14,5,9,35.71
cirencestertoyfair,13620,"['cirencester', 'toy', 'fair']",3,18,7,11,38.89
hotels-aquitaine,13614,"['hotels', 'aquitaine']",2,16,8,8,50.0
annuaire-x-porno,13611,"['aire', 'porno']",2,16,7,9,43.75
exposedmugshots,13608,"['exposed', 'mug', 'shots']",3,15,5,10,33.33
mydistributorwebsite,13608,"['distributor', 'website']",2,20,7,13,35.0
anyscaleuserdata-dev,13602,"['any', 'scale', 'user', 'data', 'dev']",5,20,8,12,40.0
chrissymacnevin,13599,"['chrissy', 'mac', 'nevin']",3,15,4,11,26.67
freevpnsecurity,13591,"['free', 'vpn', 'security']",3,15,5,10,33.33
safestcontentgate,13590,"['safest', 'content', 'gate']",3,17,6,11,35.29
cadetsdechalosse,13586,"['cadets', 'dec', 'halos']",3,16,6,10,37.5
offshoring-digest,13585,"['off', 'shoring', 'digest']",3,17,5,12,29.41
secondphaselive,13582,"['second', 'phase', 'live']",3,15,6,9,40.0
despatchcloud,13576,"['despatch', 'cloud']",2,13,4,9,30.77
multidesigners,13575,"['multi', 'designers']",2,14,5,9,35.71
headlinesacademy,13572,"['headlines', 'academy']",2,16,7,9,43.75
calebbrownforcouncil,13572,"['caleb', 'brown', 'for', 'council']",4,20,7,13,35.0
bookonline2save,13569,"['book', 'online', 'save']",3,15,7,8,46.67
wabisabi-studio,13564,"['abi', 'studio']",2,15,7,8,46.67
gabrielkeymer,13556,"['gabriel', 'keymer']",2,13,5,8,38.46
paradigma-soft,13551,"['paradigm', 'soft']",2,14,5,9,35.71
best-of-efrea,13551,['best'],1,13,5,8,38.46
jetstream-cloud,13542,"['jetstream', 'cloud']",2,15,5,10,33.33
gothok-fronap,13542,"['goth', 'fro', 'nap']",3,13,4,9,30.77
thehealthyman,13540,"['the', 'healthy', 'man']",3,13,4,9,30.77
canada-advisor,13527,"['canada', 'advisor']",2,14,6,8,42.86
dating-central,13523,"['dating', 'central']",2,14,4,10,28.57
informaticawierden,13518,"['format', 'ica', 'wie', 'rden']",4,18,8,10,44.44
kyotohotelspage,13515,"['kyoto', 'hotels', 'page']",3,15,6,9,40.0
redplanetinvestment,13513,"['red', 'planet', 'investment']",3,19,6,13,31.58
gaurdinanytime,13512,"['gaur', 'anytime']",2,14,6,8,42.86
livefilestore,13512,"['live', 'file', 'store']",3,13,6,7,46.15
yantaifujiapple,13506,"['yantai', 'fuji', 'apple']",3,15,7,8,46.67
aprohirdetoje,13477,"['pro', 'rde']",2,13,6,7,46.15
internetbilir,13470,"['internet', 'bil']",2,13,5,8,38.46
piaochengdong,13464,"['pia', 'cheng', 'dong']",3,13,5,8,38.46
schooladmindev,13460,"['school', 'admin', 'dev']",3,14,5,9,35.71
myprivatebank,13459,"['private', 'bank']",2,13,4,9,30.77
self-assesment-service,13452,"['self', 'asses', 'ment', 'service']",4,22,7,15,31.82
evanzo-server,13449,"['evan', 'server']",2,13,5,8,38.46
kbrowndesigns,13440,"['brown', 'designs']",2,13,3,10,23.08
designpythons,13431,"['design', 'pythons']",2,13,3,10,23.08
conexaosegura,13427,"['cone', 'segura']",2,13,7,6,53.85
robertostudio,13425,"['roberto', 'studio']",2,13,6,7,46.15
visionarylawgroup,13423,"['visionary', 'law', 'group']",3,17,7,10,41.18
allosakahotels,13413,"['all', 'osaka', 'hotels']",3,14,6,8,42.86
literie-daujourdhui,13407,"['lite', 'rie', 'aujourd', 'hui']",4,19,10,9,52.63
nativespeciesclothing,13400,"['native', 'species', 'clothing']",3,21,8,13,38.1
aicryptotrading,13392,"['crypto', 'trading']",2,15,5,10,33.33
hotels-in-algarve,13383,"['hotels', 'algarve']",2,17,6,11,35.29
expresscopynmore,13373,"['express', 'copy', 'more']",3,16,5,11,31.25
interlakesorthopedics,13368,"['inter', 'lakes', 'orthopedics']",3,21,8,13,38.1
dreisamufercafe,13368,"['drei', 'sam', 'ufer', 'cafe']",4,15,7,8,46.67
carolinaconnect,13353,"['carolina', 'connect']",2,15,6,9,40.0
thomsonreuters,13350,"['thomson', 'reuters']",2,14,5,9,35.71
expertscolumn,13347,"['experts', 'column']",2,13,4,9,30.77
elementconnect,13345,"['element', 'connect']",2,14,5,9,35.71
thewaternetwork,13339,"['the', 'water', 'network']",3,15,5,10,33.33
blogmarketplace,13335,"['blog', 'marketplace']",2,15,5,10,33.33
puthor-atgury,13331,"['put', 'hor', 'ury']",3,13,4,9,30.77
infinityfreeapp,13316,"['infinity', 'free', 'app']",3,15,6,9,40.0
linkjespagina,13314,"['link', 'espa', 'gina']",3,13,5,8,38.46
praemienkontor,13311,"['pra', 'emi', 'kon', 'tor']",4,14,6,8,42.86
surveygpsequipment,13308,"['survey', 'gps', 'equipment']",3,18,6,12,33.33
sonybrookphysicians,13296,"['sony', 'brook', 'physicians']",3,19,6,13,31.58
examcrackerst,13284,"['exam', 'crackers']",2,13,4,9,30.77
starwarsgalaxies,13279,"['star', 'wars', 'galaxies']",3,16,6,10,37.5
facebookadsmanager,13248,"['facebook', 'ads', 'manager']",3,18,8,10,44.44
sandy-projekt,13248,"['sandy', 'projekt']",2,13,3,10,23.08
ofertasirrepetibles,13226,"['ert', 'sir', 'pet', 'les']",4,19,8,11,42.11
kplummerenterprises,13224,"['plummer', 'enterprises']",2,19,6,13,31.58
sandyandpetejones,13223,"['sandy', 'and', 'pete', 'jones']",4,17,6,11,35.29
credit-agricole,13216,"['credit', 'agri', 'cole']",3,15,6,9,40.0
byteshieldcdn,13213,"['byte', 'shield']",2,13,3,10,23.08
earlier4programs,13200,"['earlier', 'programs']",2,16,6,10,37.5
creatifywebstudios,13200,"['crea', 'tif', 'web', 'studios']",4,18,7,11,38.89
dreamitsolution,13186,"['dream', 'solution']",2,15,7,8,46.67
benefits-services,13176,"['benefits', 'services']",2,17,6,11,35.29
turkiyematbaalari,13159,"['rkiye', 'mat', 'baal', 'ari']",4,17,8,9,47.06
340wangshangduqiu,13154,"['340', 'wang', 'shang']",3,17,5,12,29.41
furningguitaris,13152,"['fur', 'ning', 'guitar']",3,15,6,9,40.0
financialeducatorscouncil,13152,"['financial', 'educators', 'council']",3,25,11,14,44.0
cribl-staging,13152,"['crib', 'staging']",2,13,3,10,23.08
taiwansunpower,13151,"['taiwan', 'sun', 'power']",3,14,6,8,42.86
wonogirisukses,13140,"['won', 'iris', 'ses']",3,14,6,8,42.86
commuterbagpro,13138,"['commuter', 'bag', 'pro']",3,14,5,9,35.71
diversphotoweb,13137,"['divers', 'photo', 'web']",3,14,5,9,35.71
veiligbevestigen,13128,"['veil', 'vestige']",2,16,7,9,43.75
babygalerie-crivitz,13128,"['baby', 'galerie', 'rivi']",3,19,7,12,36.84
brisatelevision,13116,"['bris', 'television']",2,15,7,8,46.67
ireland-hotels,13102,"['ireland', 'hotels']",2,14,5,9,35.71
drizkl-elmutx,13101,['mut'],1,13,3,10,23.08
doktortakvimi,13099,"['doktor', 'tak', 'vim']",3,13,5,8,38.46
gregorysporleder,13096,"['gregory', 'porl', 'eder']",3,16,5,11,31.25
engagereagent,13095,"['engage', 'reagent']",2,13,6,7,46.15
reunionmanager,13093,"['reunion', 'manager']",2,14,7,7,50.0
callumpalmer17,13092,"['callum', 'palmer']",2,14,4,10,28.57
new-delhi-hotels,13087,"['new', 'delhi', 'hotels']",3,16,5,11,31.25
descargartorrent,13080,"['scar', 'gar', 'torrent']",3,16,5,11,31.25
thecoffeenerd,13069,"['the', 'coffee', 'nerd']",3,13,5,8,38.46
freedomlogicsites,13065,"['freedom', 'logic', 'sites']",3,17,7,10,41.18
chengdecunguan,13056,"['cheng', 'dec', 'guan']",3,14,5,9,35.71
zgqingnianlxs,13053,"['gni', 'anl']",2,13,3,10,23.08
classificadosbr,13051,"['class', 'ica', 'dos']",3,15,5,10,33.33
thunderbirdbroadband,13050,"['thunderbird', 'broadband']",2,20,6,14,30.0
witfar-ochala,13039,"['wit', 'far', 'och']",3,13,5,8,38.46
blackwoodspurs,13035,"['blackwood', 'spurs']",2,14,4,10,28.57
digitalempire,13034,"['digital', 'empire']",2,13,6,7,46.15
waynethomasoakes,13033,"['wayne', 'thomas', 'oakes']",3,16,7,9,43.75
wellnesscoach,13032,"['wellness', 'coach']",2,13,4,9,30.77
stopanchorbabies,13032,"['stop', 'anchor', 'babies']",3,16,6,10,37.5
shoptruevalue,13024,"['shop', 'true', 'value']",3,13,6,7,46.15
videosexyporno,13023,"['video', 'sexy', 'porno']",3,14,6,8,42.86
en-construccio,13020,"['const', 'ruc', 'cio']",3,14,5,9,35.71
weblinkconnect,13017,"['web', 'link', 'connect']",3,14,4,10,28.57
voipinnovations,13013,"['voip', 'innovations']",2,15,7,8,46.67
univ-paris-diderot,13011,"['paris', 'diderot']",2,18,7,11,38.89
hotelsofwisconsin,13011,"['hotels', 'wisconsin']",2,17,6,11,35.29
tradingtrainer,13007,"['trading', 'trainer']",2,14,5,9,35.71
bethaus-speyer,12987,"['beth', 'speyer']",2,14,5,9,35.71
thereadersart,12986,"['the', 'readers', 'art']",3,13,5,8,38.46
advancepaydayplus,12972,"['advance', 'payday', 'plus']",3,17,6,11,35.29
microsoft-pme,12968,['microsoft'],1,13,4,9,30.77
leedsnewmedia,12963,"['leeds', 'new', 'media']",3,13,6,7,46.15
cherrygelinlik,12957,"['cherry', 'gel']",2,14,4,10,28.57
chinafastener,12956,"['china', 'fastener']",2,13,5,8,38.46
allbrittanyhotels,12948,"['all', 'brittany', 'hotels']",3,17,5,12,29.41
southislandnz,12939,"['south', 'island']",2,13,4,9,30.77
energy-courses,12908,"['energy', 'courses']",2,14,5,9,35.71
ohiobesthotels,12893,"['ohio', 'best', 'hotels']",3,14,6,8,42.86
vocationcollege,12888,"['vocation', 'college']",2,15,7,8,46.67
lenoxhillradoilogy,12888,"['lenox', 'hill', 'doi', 'logy']",4,18,7,11,38.89
highlandshotelspage,12864,"['highlands', 'hotels', 'page']",3,19,6,13,31.58
greenlifeadventuresports,12864,"['green', 'life', 'adventure', 'sports']",4,24,9,15,37.5
onlinesolutions,12855,"['online', 'solutions']",2,15,7,8,46.67
san-francisco-bay,12849,"['san', 'francisco', 'bay']",3,17,5,12,29.41
schoolinsites,12849,"['school', 'sites']",2,13,5,8,38.46
insightsquared,12842,"['insight', 'squared']",2,14,5,9,35.71
gatetotrustednetwork,12840,"['gate', 'trusted', 'network']",3,20,7,13,35.0
webserversystems,12832,"['web', 'server', 'systems']",3,16,4,12,25.0
container-dieckhoff,12804,"['container', 'die', 'hoff']",3,19,7,12,36.84
thescoutguide,12795,"['the', 'scout', 'guide']",3,13,6,7,46.15
fasttrackcomm,12792,"['fast', 'track', 'com']",3,13,3,10,23.08
satisfyerstore,12788,"['satisfy', 'store']",2,14,5,9,35.71
mariannehallberg,12779,"['marianne', 'hall', 'berg']",3,16,6,10,37.5
five-starpivot,12769,"['five', 'star', 'pivot']",3,14,5,9,35.71
renaissanceunity,12765,"['renaissance', 'unity']",2,16,7,9,43.75
motionpicturegroup,12756,"['motion', 'picture', 'group']",3,18,8,10,44.44
cmaschoolsatna,12756,"['cma', 'schools', 'tna']",3,14,5,9,35.71
business-trade,12750,"['business', 'trade']",2,14,5,9,35.71
mialojamiento,12747,"['alo', 'jamie']",2,13,7,6,53.85
lakecountrymn,12746,"['lake', 'country']",2,13,4,9,30.77
tvcontinental,12736,['continental'],1,13,4,9,30.77
rosenblumcellars,12735,"['rosenblum', 'cellars']",2,16,5,11,31.25
securityjourney,12734,"['security', 'journey']",2,15,6,9,40.0
wwwlaoniuyingshi,12724,"['www', 'lao', 'niu', 'ying', 'shi']",5,16,6,10,37.5
thecraftproject,12720,"['the', 'craft', 'project']",3,15,4,11,26.67
adios-staging,12712,"['adios', 'staging']",2,13,5,8,38.46
alternativacontable,12710,"['alter', 'nat', 'con', 'table']",4,19,8,11,42.11
103-applefibernet,12709,"['103', 'apple', 'fiber', 'net']",4,17,5,12,29.41
surgeryaccess,12708,"['surgery', 'access']",2,13,4,9,30.77
machineryhostdns,12706,"['machinery', 'host', 'dns']",3,16,4,12,25.0
empirepromotion,12702,"['empire', 'promotion']",2,15,7,8,46.67
pcchomebuilders,12696,"['pcc', 'home', 'builders']",3,15,5,10,33.33
onelink-translations,12694,"['onelink', 'translations']",2,20,7,13,35.0
tophotelsvienna,12690,"['top', 'hotels', 'vienna']",3,15,6,9,40.0
proyectaemprender,12684,"['pro', 'yec', 'tae', 'render']",4,17,6,11,35.29
younglivingconnect,12672,"['young', 'living', 'connect']",3,18,6,12,33.33
yourfantasyfootballpicks,12672,"['your', 'fantasy', 'football', 'picks']",4,24,8,16,33.33
brilliancemodels,12655,"['brilliance', 'models']",2,16,6,10,37.5
directofferxxx,12648,"['direct', 'offer', 'xxx']",3,14,4,10,28.57
paikarymarket,12636,"['pai', 'kary', 'market']",3,13,5,8,38.46
badoexen-bestellsystem,12636,"['bad', 'xen', 'tell', 'system']",4,22,7,15,31.82
unifyprotection,12636,"['unify', 'protection']",2,15,6,9,40.0
needhamluxuryhomes,12633,"['needham', 'luxury', 'homes']",3,18,7,11,38.89
hotels-of-chengdu,12633,"['hotels', 'chengdu']",2,17,5,12,29.41
burkehandling,12626,"['burke', 'handling']",2,13,4,9,30.77
tanzschule-wertenbruch,12612,"['tanz', 'schule', 'rten', 'bruch']",4,22,6,16,27.27
go-nice-hotels,12612,"['nice', 'hotels']",2,14,5,9,35.71
fastboycompany,12609,"['fast', 'boy', 'company']",3,14,4,10,28.57
realfollowers,12599,"['real', 'followers']",2,13,5,8,38.46
spartanapproach,12591,"['spartan', 'approach']",2,15,5,10,33.33
24x7houseplan,12588,"['house', 'plan']",2,13,4,9,30.77
broomfieldvoice,12588,"['broomfield', 'voice']",2,15,7,8,46.67
pornvideospider,12585,"['porn', 'video', 'spider']",3,15,6,9,40.0
jianzhujiancaiwang,12576,"['jian', 'zhu', 'jian', 'cai', 'wang']",5,18,8,10,44.44
nrwestphaliahotels,12573,"['westphalia', 'hotels']",2,18,6,12,33.33
oracleindustry,12565,"['oracle', 'industry']",2,14,5,9,35.71
hotels-tokyo-jp,12551,"['hotels', 'tokyo']",2,15,4,11,26.67
mandygirl-exposed,12546,"['mandy', 'girl', 'exposed']",3,17,5,12,29.41
oldindiannotecoin,12540,"['old', 'indian', 'note', 'coin']",4,17,8,9,47.06
pinetreenetworks,12537,"['pine', 'tree', 'networks']",3,16,6,10,37.5
hairdiagnosis,12534,"['hair', 'diagnosis']",2,13,6,7,46.15
hubspotusercontent-na1,12530,"['hub', 'spot', 'user', 'content']",4,22,7,15,31.82
networkforgood,12525,"['network', 'for', 'good']",3,14,5,9,35.71
backdoorpodcasts,12518,"['backdoor', 'podcasts']",2,16,5,11,31.25
directcolocation,12512,"['direct', 'location']",2,16,7,9,43.75
languedoc-hotels,12505,"['languedoc', 'hotels']",2,16,6,10,37.5
hangzhouhotelsweb,12504,"['hangzhou', 'hotels', 'web']",3,17,6,11,35.29
poweredbyclear,12501,"['powered', 'clear']",2,14,5,9,35.71
hotelsofmaryland,12498,"['hotels', 'maryland']",2,16,5,11,31.25
assistirtvonlinehd,12498,"['assist', 'online']",2,18,6,12,33.33
tamildubmovies,12496,"['tamil', 'dub', 'movies']",3,14,6,8,42.86
hotels-burgas,12495,"['hotels', 'burg']",2,13,4,9,30.77
heliobroadband,12495,"['lio', 'broadband']",2,14,6,8,42.86
motorsykkelsider,12492,"['motors', 'ykk', 'side']",3,16,5,11,31.25
eagledreamhealth,12492,"['eagle', 'dream', 'health']",3,16,7,9,43.75
securehostdns,12483,"['secure', 'host', 'dns']",3,13,4,9,30.77
healthyfoodrecipies,12483,"['healthy', 'food', 'rec', 'pies']",4,19,8,11,42.11
devontophotels,12477,"['devon', 'top', 'hotels']",3,14,5,9,35.71
101kofemashina,12475,"['101', 'fema', 'shina']",3,14,5,9,35.71
wedoitrightmag,12474,"['right', 'mag']",2,14,5,9,35.71
hotelschiangmai,12471,"['hotels', 'chiang', 'mai']",3,15,6,9,40.0
litcoinfaucet,12458,"['lit', 'coin', 'faucet']",3,13,6,7,46.15
forums-actifs,12456,"['forums', 'act']",2,13,4,9,30.77
costa-de-valencia,12453,"['costa', 'valencia']",2,17,7,10,41.18
whoknowsaguyfitness,12450,"['who', 'knows', 'guy', 'fitness']",4,19,6,13,31.58
willitsonline,12446,"['will', 'its', 'online']",3,13,5,8,38.46
krytonitelock,12441,"['nite', 'lock']",2,13,4,9,30.77
sudeste-do-brasil-hoteis,12435,"['sud', 'este', 'brasil', 'hotei']",4,24,9,15,37.5
blackaspenpropertymanagement,12420,"['black', 'aspen', 'property', 'management']",4,28,9,19,32.14
fluginformationen,12408,"['flu', 'information']",2,17,7,10,41.18
illinoisonline,12403,"['illinois', 'online']",2,14,7,7,50.0
madisoncounty,12401,"['madison', 'county']",2,13,5,8,38.46
anytimeaccess,12401,"['anytime', 'access']",2,13,5,8,38.46
churchbooklive,12387,"['church', 'book', 'live']",3,14,5,9,35.71
rush-analytics-test,12384,"['rush', 'analytics', 'test']",3,19,5,14,26.32
sitedesignnyc,12384,"['site', 'design', 'nyc']",3,13,4,9,30.77
mentemilionaria,12377,"['ment', 'emilio', 'nari']",3,15,8,7,53.33
suburbanlandscaping,12374,"['suburban', 'landscaping']",2,19,6,13,31.58
busconegocios,12365,"['bus', 'cone', 'cio']",3,13,6,7,46.15
freeessaywriters,12361,"['free', 'essay', 'writers']",3,16,6,10,37.5
huffingtonpost,12360,"['huffington', 'post']",2,14,4,10,28.57
lame-delegation,12339,"['lame', 'delegation']",2,15,7,8,46.67
catlabroadband,12331,"['cat', 'broadband']",2,14,5,9,35.71
albertahotelsmotels,12327,"['alberta', 'hotels', 'motels']",3,19,7,12,36.84
indiansexvideo,12311,"['indian', 'sex', 'video']",3,14,7,7,50.0
chappellcapital,12307,"['chappell', 'capital']",2,15,5,10,33.33
property-press,12306,"['property', 'press']",2,14,3,11,21.43
official-wedding,12304,"['official', 'wedding']",2,16,6,10,37.5
livecodehosting,12295,"['live', 'code', 'hosting']",3,15,6,9,40.0
webspace-verkauf,12293,"['web', 'space', 'ver', 'auf']",4,16,6,10,37.5
costaazaharhoteles,12288,"['costa', 'aza', 'har', 'hotel']",4,18,8,10,44.44
chicago-metropolitan-area,12288,"['chicago', 'metropolitan', 'area']",3,25,11,14,44.0
girlsgonechild,12267,"['girls', 'gone', 'child']",3,14,4,10,28.57
eriecountygov,12267,"['erie', 'county', 'gov']",3,13,6,7,46.15
manilahotelsphilippines,12261,"['manila', 'hotels', 'philippines']",3,23,9,14,39.13
yantai-salvage,12260,"['yantai', 'salvage']",2,14,6,8,42.86
man-acoustics,12256,"['man', 'acoustics']",2,13,5,8,38.46
curryparadisewitney,12254,"['curry', 'paradise', 'witney']",3,19,7,12,36.84
teamsportsadmin,12254,"['team', 'sports', 'admin']",3,15,5,10,33.33
pessimistsbeware,12253,"['pessimists', 'beware']",2,16,6,10,37.5
taberna-saponaria,12252,"['taber', 'saponaria']",2,17,8,9,47.06
jingcaituijian,12252,"['jing', 'cait', 'jian']",3,14,7,7,50.0
laitilanmetro,12246,"['ilan', 'metro']",2,13,6,7,46.15
orga-products,12240,"['org', 'products']",2,13,4,9,30.77
earlier2response,12240,"['earlier', 'response']",2,16,7,9,43.75
meusjogosonline,12238,"['jogo', 'online']",2,15,7,8,46.67
allpiterhotels,12237,"['all', 'pite', 'hotels']",3,14,5,9,35.71
brazoria-inet,12232,['brazoria'],1,13,6,7,46.15
syringawireless,12229,"['syringa', 'wireless']",2,15,5,10,33.33
cambridgeshireeducationaltrust,12228,"['cambridgeshire', 'educational', 'trust']",3,30,12,18,40.0
hosted-by-eurohoster,12228,"['hosted', 'euro', 'host']",3,20,7,13,35.0
forumchitchat,12227,"['forum', 'chitchat']",2,13,4,9,30.77
surveyanalytics,12226,"['survey', 'analytics']",2,15,5,10,33.33
corfugreecehotels,12225,"['corfu', 'greece', 'hotels']",3,17,7,10,41.18
tipobetyardim,12222,"['tipo', 'bet', 'yard']",3,13,5,8,38.46
farragutwines,12218,"['farragut', 'wines']",2,13,5,8,38.46
hostedincanadasurveys,12211,"['hosted', 'canada', 'surveys']",3,21,8,13,38.1
thefirstrowapp,12204,"['the', 'first', 'row', 'app']",4,14,4,10,28.57
havilandtelco,12195,"['avil', 'and', 'tel']",3,13,5,8,38.46
myaccountsocalgas,12189,"['account', 'cal', 'gas']",3,17,6,11,35.29
affordablemouldings,12186,"['affordable', 'mouldings']",2,19,7,12,36.84
tipsdefitness,12180,"['tips', 'fitness']",2,13,4,9,30.77
rainierconnect,12171,"['rainier', 'connect']",2,14,6,8,42.86
galaxydigitel,12170,"['galaxy', 'digitel']",2,13,5,8,38.46
edgekey-staging,12168,"['edge', 'key', 'staging']",3,15,5,10,33.33
fusionconnect,12168,"['fusion', 'connect']",2,13,5,8,38.46
airconditioner,12166,"['air', 'conditioner']",2,14,7,7,50.0
idlwebclients,12157,"['idl', 'web', 'clients']",3,13,4,9,30.77
fastrootserver,12146,"['fast', 'root', 'server']",3,14,5,9,35.71
mannatreatment,12146,"['manna', 'treatment']",2,14,5,9,35.71
gaoxiaowenxue,12144,"['gao', 'xia', 'owen', 'xue']",4,13,8,5,61.54
wb-siteminder,12141,"['site', 'minder']",2,13,4,9,30.77
indiabangalorehotels,12132,"['india', 'bangalore', 'hotels']",3,20,9,11,45.0
insideoutlifecoach,12132,"['inside', 'out', 'life', 'coach']",4,18,9,9,50.0
callmenowhomeservices,12126,"['call', 'now', 'home', 'services']",4,21,8,13,38.1
evangelizacionvalencia,12120,"['evan', 'geli', 'zac', 'ion', 'valencia']",5,22,11,11,50.0
austinjournlss,12108,"['austin', 'journ']",2,14,5,9,35.71
jweiland-hosting,12105,"['weiland', 'hosting']",2,16,5,11,31.25
starwarskidfan,12096,"['star', 'war', 'skid', 'fan']",4,14,4,10,28.57
ownmyowntruck,12093,"['own', 'own', 'truck']",3,13,3,10,23.08
iwantwireless,12084,"['want', 'wireless']",2,13,5,8,38.46
lossantoslifeitalia,12083,"['los', 'santos', 'life', 'italia']",4,19,9,10,47.37
kimberly-clark,12080,"['kimberly', 'clark']",2,14,3,11,21.43
lovecollection,12077,"['love', 'collection']",2,14,6,8,42.86
meltingpotforum,12072,"['melting', 'pot', 'forum']",3,15,5,10,33.33
demowebsiteworks,12063,"['demo', 'website', 'works']",3,16,6,10,37.5
hdcdatacentre,12061,"['data', 'centre']",2,13,4,9,30.77
rougevalleysiw,12031,"['rouge', 'valleys']",2,14,6,8,42.86
nttlikedomains2,12030,"['ntt', 'like', 'domains']",3,15,5,10,33.33
besthotelsinlouisiana,12021,"['best', 'hotels', 'louisiana']",3,21,10,11,47.62
pussycatdolls,12016,['pussycatdolls'],1,13,3,10,23.08
douglasconnect,12006,"['douglas', 'connect']",2,14,5,9,35.71
matthewwilliamson,12005,"['matthew', 'williamson']",2,17,6,11,35.29
catalogrossii,12004,"['catalog', 'ross']",2,13,6,7,46.15
toprevenuenetwork,12000,"['top', 'revenue', 'network']",3,17,7,10,41.18
asiantigermosquito,11995,"['asian', 'tiger', 'mosquito']",3,18,9,9,50.0
miaoweijianfei,11991,"['miaow', 'eiji', 'fei']",3,14,9,5,64.29
nonlineardynamics,11985,"['nonlinear', 'dynamics']",2,17,6,11,35.29
hotelinmarrakech,11976,"['hotel', 'marrakech']",2,16,6,10,37.5
expat-finance,11952,"['exp', 'finance']",2,13,5,8,38.46
sterlingnetwork,11949,"['sterling', 'network']",2,15,4,11,26.67
go2westernaustralia,11949,"['western', 'australia']",2,19,8,11,42.11
vautronserver,11945,"['vau', 'tron', 'server']",3,13,5,8,38.46
belaastingdienst,11940,"['bela', 'sting', 'dien']",3,16,6,10,37.5
camgirlssexshow,11939,"['cam', 'girls', 'sex', 'show']",4,15,4,11,26.67
lamaisondestravaux,11934,"['lama', 'stra', 'vaux']",3,18,8,10,44.44
ringpublishing,11933,"['ring', 'publishing']",2,14,4,10,28.57
caritas-duesseldorf,11931,"['car', 'due', 'sseldorf']",3,19,7,12,36.84
rto-home-search,11928,"['home', 'search']",2,15,5,10,33.33
camgirl-exposed,11928,"['cam', 'girl', 'exposed']",3,15,5,10,33.33
unitedwireless,11928,"['united', 'wireless']",2,14,6,8,42.86
gorod-masterov-rf,11925,"['rod', 'master']",2,17,5,12,29.41
caiwangschool,11925,"['cai', 'wang', 'school']",3,13,5,8,38.46
streamingaltadefinizione,11923,"['streaming', 'alta', 'def', 'one']",4,24,11,13,45.83
gunpowdergolf,11923,"['gunpowder', 'golf']",2,13,4,9,30.77
hanse-autoteile,11916,"['hanse', 'auto', 'teil']",3,15,8,7,53.33
tripadvisorreview,11900,"['trip', 'advisor', 'review']",3,17,7,10,41.18
hotels-in-hanoi,11892,"['hotels', 'hanoi']",2,15,6,9,40.0
maldivesassetplc,11892,"['maldives', 'asset', 'plc']",3,16,5,11,31.25
follettdestiny,11889,"['follett', 'destiny']",2,14,4,10,28.57
itsallaboutmoney,11887,"['its', 'all', 'about', 'money']",4,16,7,9,43.75
telugusexvideos,11887,"['telugu', 'sex', 'videos']",3,15,7,8,46.67
hausstellingen,11880,"['haus', 'stelling']",2,14,5,9,35.71
chatmosscable,11877,"['chat', 'moss', 'cable']",3,13,4,9,30.77
ghostbustersishiring,11875,"['ghostbusters', 'hiring']",2,20,6,14,30.0
itea2-artemisia,11870,['artemisia'],1,15,8,7,53.33
ruttenparfums,11868,"['rutten', 'parfums']",2,13,4,9,30.77
searchfriendlyvideos,11865,"['search', 'friendly', 'videos']",3,20,7,13,35.0
osaka-hotels-info,11862,"['osaka', 'hotels', 'info']",3,17,7,10,41.18
twincitieshomeexpert,11860,"['twin', 'cities', 'home', 'expert']",4,20,8,12,40.0
santorinihotelsonline,11856,"['santorini', 'hotels', 'online']",3,21,9,12,42.86
healingwithhind,11844,"['healing', 'with', 'hind']",3,15,5,10,33.33
hundeschule-saulheim,11844,"['hun', 'schule', 'saul', 'heim']",4,20,8,12,40.0
bekanntwerden,11844,"['kann', 'werden']",2,13,4,9,30.77
selbsthilfe-community,11841,"['sel', 'bst', 'hil', 'community']",4,21,6,15,28.57
integration-takeaway,11837,"['integration', 'take', 'away']",3,20,9,11,45.0
xuanyangyaoye,11830,"['anyang', 'yao']",2,13,6,7,46.15
yuanquanjiaju,11822,"['yuan', 'quan', 'jia']",3,13,7,6,53.85
tischtennisberlin,11820,"['tisch', 'tennis', 'berlin']",3,17,5,12,29.41
livesexpremium,11820,"['live', 'sex', 'premium']",3,14,6,8,42.86
infinitebidding,11810,"['infinite', 'bidding']",2,15,6,9,40.0
websiteonline,11808,"['website', 'online']",2,13,6,7,46.15
resources-search,11796,"['resources', 'search']",2,16,6,10,37.5
hindisexvideo,11791,"['hindi', 'sex', 'video']",3,13,6,7,46.15
mental-harmony,11790,"['mental', 'harmony']",2,14,4,10,28.57
xcodereleases,11787,"['code', 'releases']",2,13,6,7,46.15
virtuallearning,11776,"['virtual', 'learning']",2,15,6,9,40.0
trolltunga-road,11768,"['troll', 'tung', 'road']",3,15,5,10,33.33
ufosoverarea51,11763,"['ufos', 'over', 'area']",3,14,7,7,50.0
spryserversdc,11760,"['spry', 'servers']",2,13,2,11,15.38
adsconsultancy,11757,"['ads', 'consultancy']",2,14,4,10,28.57
los-angeles-hotel,11754,"['los', 'angeles', 'hotel']",3,17,6,11,35.29
theragunrussia,11754,"['thera', 'gun', 'russia']",3,14,6,8,42.86
greatfamilyescape,11746,"['great', 'family', 'escape']",3,17,7,10,41.18
lighthousedeli,11736,"['lighthouse', 'deli']",2,14,6,8,42.86
grancanaria-hotels,11735,"['gran', 'canaria', 'hotels']",3,18,7,11,38.89
visualizetraffic,11727,"['visualize', 'traffic']",2,16,7,9,43.75
birkenwappen-shelties,11724,"['birk', 'wappen', 'shelties']",3,21,7,14,33.33
pinnacle-solution,11712,"['pinnacle', 'solution']",2,17,7,10,41.18
samsunglaunchsupport,11710,"['samsung', 'launch', 'support']",3,20,6,14,30.0
chaturbategirls,11697,"['chat', 'bate', 'girls']",3,15,5,10,33.33
fuzhuangzhiban,11696,"['zhuang', 'zhi', 'ban']",3,14,5,9,35.71
hotel-wedding,11696,"['hotel', 'wedding']",2,13,4,9,30.77
fengtaiguoyuan,11693,"['feng', 'tai', 'guo', 'yuan']",4,14,7,7,50.0
gdhealthzones,11688,"['health', 'zones']",2,13,4,9,30.77
indianahotelsweb,11682,"['indiana', 'hotels', 'web']",3,16,7,9,43.75
chinashangzheng,11676,"['china', 'shang', 'zheng']",3,15,4,11,26.67
muslimresource,11675,"['muslim', 'resource']",2,14,6,8,42.86
technologiehersteltag,11674,"['techno', 'logie', 'her', 'tel', 'tag']",5,21,8,13,38.1
remont-stroy24,11674,"['mont', 'troy']",2,14,3,11,21.43
bedfordresearcher,11671,"['bedford', 'researcher']",2,17,6,11,35.29
bodylightening,11664,"['body', 'lightening']",2,14,4,10,28.57
yourfreedating,11664,"['your', 'free', 'dating']",3,14,6,8,42.86
spinautomobili,11664,"['spin', 'automobili']",2,14,7,7,50.0
sports-illustrated-magazine,11664,"['sports', 'illustrated', 'magazine']",3,27,9,18,33.33
camscandal-exposed,11658,"['cam', 'scandal', 'exposed']",3,18,6,12,33.33
vermeerlouisiana,11646,"['vermeer', 'louisiana']",2,16,9,7,56.25
findyourmatchnow,11642,"['find', 'your', 'match', 'now']",4,16,5,11,31.25
remax-michigan,11637,"['max', 'michigan']",2,14,5,9,35.71
com-girlfriends,11628,"['com', 'girlfriends']",2,15,4,11,26.67
ddosinternational,11619,"['dos', 'international']",2,17,7,10,41.18
realsexscandals,11619,"['real', 'sex', 'scandals']",3,15,5,10,33.33
hotelsofamsterdam,11617,"['hotels', 'amsterdam']",2,17,6,11,35.29
zwiebelquetsche,11616,"['wie', 'bel', 'que', 'tsch']",4,15,6,9,40.0
mipuertocortes,11610,"['puerto', 'cortes']",2,14,6,8,42.86
ultraconditioning,11592,"['ultra', 'conditioning']",2,17,7,10,41.18
chinaappletree,11580,"['china', 'apple', 'tree']",3,14,6,8,42.86
schneider-druckluft-shop,11565,"['schneider', 'uck', 'luft', 'shop']",4,24,6,18,25.0
investorfriendlyclassifieds,11556,"['investor', 'friendly', 'classifieds']",3,27,9,18,33.33
blackdiamondradio,11549,"['black', 'diamond', 'radio']",3,17,7,10,41.18
sexadultgirls,11531,"['sex', 'adult', 'girls']",3,13,4,9,30.77
dns-solutions,11529,"['dns', 'solutions']",2,13,4,9,30.77
vetsfirstchoice,11512,"['vets', 'first', 'choice']",3,15,5,10,33.33
myvehiclesite,11502,"['vehicle', 'site']",2,13,5,8,38.46
metaverseworld247,11501,"['meta', 'verse', 'world', '247']",4,17,5,12,29.41
imperiosacperu,11500,"['imperio', 'sac', 'peru']",3,14,7,7,50.0
romehotels365,11499,"['rome', 'hotels', '365']",3,13,4,9,30.77
teamsnapsites,11488,"['team', 'snap', 'sites']",3,13,5,8,38.46
hotelmapguide,11481,"['hotel', 'map', 'guide']",3,13,6,7,46.15
babeliciousbabes,11478,"['babe', 'licious', 'babes']",3,16,8,8,50.0
industrialpartner,11478,"['industrial', 'partner']",2,17,6,11,35.29
ingilizcedunyam,11472,"['gili', 'ced', 'yam']",3,15,6,9,40.0
methodsforchange,11470,"['methods', 'for', 'change']",3,16,5,11,31.25
croatiahotel24,11468,"['croatia', 'hotel']",2,14,6,8,42.86
memorialstores,11466,"['memorial', 'stores']",2,14,6,8,42.86
sidezockinglp,11466,"['side', 'king']",2,13,4,9,30.77
delonghiservice,11457,"['long', 'service']",2,15,6,9,40.0
hotelsriodejaneiro,11457,"['hotels', 'rio', 'janeiro']",3,18,9,9,50.0
allxianhotels,11451,"['all', 'xian', 'hotels']",3,13,5,8,38.46
kepner-tregoe,11447,"['ner', 'tre']",2,13,5,8,38.46
hotels-in-rhodes-greece,11445,"['hotels', 'rhodes', 'greece']",3,23,8,15,34.78
wangpolongxia,11444,"['wang', 'long', 'xia']",3,13,5,8,38.46
online-registratie,11436,"['online', 'regis', 'tra', 'tie']",4,18,8,10,44.44
controleplatform,11436,"['control', 'platform']",2,16,5,11,31.25
petralindholm,11434,"['petra', 'lind', 'holm']",3,13,4,9,30.77
hansoninfosys,11427,"['hanson', 'info']",2,13,4,9,30.77
project-virality,11421,"['project', 'viral']",2,16,5,11,31.25
swiss21-commerce,11418,"['swiss', 'commerce']",2,16,4,12,25.0
bitebankwebsites,11415,"['bite', 'bank', 'websites']",3,16,6,10,37.5
empiezatutrabajo,11412,"['pie', 'zat', 'trabajo']",3,16,8,8,50.0
abonamentiptv,11412,"['bona', 'ment', 'iptv']",3,13,5,8,38.46
club-internet,11411,"['club', 'internet']",2,13,4,9,30.77
mortgageautomator,11409,"['mortgage', 'auto', 'mat']",3,17,8,9,47.06
new-image-dental,11388,"['new', 'image', 'dental']",3,16,6,10,37.5
blandineetfab,11381,"['bland', 'eet', 'fab']",3,13,5,8,38.46
frisoverzicht,11367,['over'],1,13,4,9,30.77
achievablecpmrevenue,11360,"['achievable', 'revenue']",2,20,9,11,45.0
camgirls-exposed,11352,"['cam', 'girls', 'exposed']",3,16,5,11,31.25
getnoticedfirst,11346,"['get', 'noticed', 'first']",3,15,5,10,33.33
pierre-schaefer,11343,"['pierre', 'schaefer']",2,15,6,9,40.0
sewingmachinebag,11333,"['sewing', 'machine', 'bag']",3,16,6,10,37.5
autoland-frankbernhard,11328,"['auto', 'land', 'frank', 'bernhard']",4,22,7,15,31.82
zhonghaishenlong,11323,"['zhong', 'hai', 'shen', 'long']",4,16,5,11,31.25
genstarnetcable,11322,"['gen', 'star', 'net', 'cable']",4,15,5,10,33.33
websexcamgirls,11319,"['web', 'sex', 'cam', 'girls']",4,14,4,10,28.57
skincarewithdiamonds,11316,"['skin', 'care', 'with', 'diamonds']",4,20,7,13,35.0
besthotelsriodejaneiro,11313,"['best', 'hotels', 'rio', 'janeiro']",4,22,10,12,45.45
melisa-undehv,11311,['melis'],1,13,5,8,38.46
strongstonerus,11302,"['strong', 'stoner']",2,14,4,10,28.57
servercompanies,11296,"['server', 'companies']",2,15,6,9,40.0
kingdomtalkonline,11292,"['kingdom', 'talk', 'online']",3,17,6,11,35.29
escortsvancouver,11289,"['escorts', 'vancouver']",2,16,6,10,37.5
countymugshots,11288,"['county', 'mug', 'shots']",3,14,4,10,28.57
transformyourmoney,11287,"['transform', 'your', 'money']",3,18,6,12,33.33
greenearthpublications,11285,"['green', 'earth', 'publications']",3,22,9,13,40.91
educar-escuela,11283,"['edu', 'car', 'escuela']",3,14,7,7,50.0
eritai-philad,11278,"['itai', 'phil']",2,13,6,7,46.15
kundenserver42,11277,"['nden', 'server']",2,14,4,10,28.57
sportsstories,11271,"['sports', 'stories']",2,13,4,9,30.77
blogmarketingtips,11268,"['blog', 'marketing', 'tips']",3,17,5,12,29.41
everythingservers,11268,"['everything', 'servers']",2,17,5,12,29.41
capetownhotelsearch,11268,"['capetown', 'hotel', 'search']",3,19,7,12,36.84
vaalerengaskolesmusikkorps,11267,"['vaaler', 'enga', 'skol', 'musik', 'korps']",5,26,10,16,38.46
naples-top-hotels,11265,"['naples', 'top', 'hotels']",3,17,5,12,29.41
vacationrenter,11252,"['vacation', 'renter']",2,14,6,8,42.86
versatileadvancement,11250,"['versatile', 'advancement']",2,20,8,12,40.0
dallasdigitalstudios,11249,"['dallas', 'digital', 'studios']",3,20,8,12,40.0
kanopystreaming,11248,"['kano', 'streaming']",2,15,5,10,33.33
hotelspattayacity,11247,"['hotels', 'pattaya', 'city']",3,17,6,11,35.29
bonnesparoles,11243,"['bonne', 'paroles']",2,13,5,8,38.46
cryptodailyprofit,11232,"['crypto', 'daily', 'profit']",3,17,5,12,29.41
marksrvtelecom,11226,"['marks', 'telecom']",2,14,4,10,28.57
genericlevitraprice,11217,"['generic', 'levi', 'trap', 'rice']",4,19,8,11,42.11
vinayaklogistics,11214,"['vinayak', 'logistics']",2,16,6,10,37.5
megaseriestorrent,11200,"['mega', 'series', 'torrent']",3,17,7,10,41.18
onlinebooking,11199,"['online', 'booking']",2,13,6,7,46.15
brilliantalliance,11199,"['brilliant', 'alliance']",2,17,7,10,41.18
mytrip-hotels,11199,"['trip', 'hotels']",2,13,3,10,23.08
mimiyori-girls,11198,"['mimi', 'yori', 'girls']",3,14,5,9,35.71
gulatischoolofphotography,11184,"['gul', 'school', 'photography']",3,25,9,16,36.0
epdus-lderoxl,11169,['lder'],1,13,4,9,30.77
gaytubevideos,11163,"['gay', 'tube', 'videos']",3,13,6,7,46.15
featureupvote,11163,"['feature', 'vote']",2,13,7,6,53.85
thefiscaltimes,11159,"['the', 'fiscal', 'times']",3,14,5,9,35.71
vermeercolorado,11151,"['vermeer', 'colorado']",2,15,7,8,46.67
paradoxreporting,11136,"['paradox', 'reporting']",2,16,6,10,37.5
ceciliaaccardo,11134,"['cecilia', 'cardo']",2,14,7,7,50.0
richmondmexicanfood,11133,"['richmond', 'mexican', 'food']",3,19,7,12,36.84
arcopackaging,11119,"['arco', 'packaging']",2,13,5,8,38.46
culturaencadena,11118,"['cultura', 'enc', 'aden']",3,15,7,8,46.67
sydneyhotelsnet,11118,"['sydney', 'hotels', 'net']",3,15,4,11,26.67
bookstoreforall,11116,"['bookstore', 'for', 'all']",3,15,6,9,40.0
hotels-kualalumpur,11113,"['hotels', 'kuala', 'lumpur']",3,18,7,11,38.89
filbetalpha-esports,11106,"['fil', 'bet', 'alpha', 'sports']",4,19,6,13,31.58
zhouyishudian,11103,"['zhou', 'shu', 'dian']",3,13,6,7,46.15
autodoorsystem,11100,"['auto', 'door', 'system']",3,14,6,8,42.86
grundycountyspeedway,11096,"['grundy', 'county', 'speedway']",3,20,6,14,30.0
zimmerei-bremen,11091,"['zimmer', 'bremen']",2,15,6,9,40.0
billionyuanfood,11089,"['billion', 'yuan', 'food']",3,15,7,8,46.67
planningcenteronline,11085,"['planning', 'center', 'online']",3,20,7,13,35.0
247azpropertysearch,11080,"['247', 'property', 'search']",3,19,5,14,26.32
kaercher-center-fn,11079,"['rcher', 'center']",2,18,5,13,27.78
appmobileforce,11074,"['app', 'mobile', 'force']",3,14,6,8,42.86
pierre-markuse,11072,"['pierre', 'mark', 'use']",3,14,6,8,42.86
kyotohotelsjapan,11065,"['kyoto', 'hotels', 'japan']",3,16,6,10,37.5
cache3responses,11064,"['cache', 'responses']",2,15,5,10,33.33
chatroulettealternatives,11058,"['chat', 'roulette', 'alternatives']",3,24,10,14,41.67
netriplexboston,11045,"['triple', 'boston']",2,15,5,10,33.33
smiletondental,11043,"['smile', 'ton', 'dental']",3,14,5,9,35.71
splendid-hosting,11042,"['splendid', 'hosting']",2,16,4,12,25.0
paymentsenterbank,11040,"['payments', 'enter', 'bank']",3,17,5,12,29.41
gvodatacenter,11031,['datacenter'],1,13,5,8,38.46
documentalizate,11020,"['document', 'aliz', 'ate']",3,15,7,8,46.67
xiamenchinahotels,11019,"['xiamen', 'china', 'hotels']",3,17,7,10,41.18
bahia-del-duque,11016,"['bahia', 'del', 'duque']",3,15,7,8,46.67
privy-staging,11010,"['privy', 'staging']",2,13,3,10,23.08
ascensionlutheranhuntsville,10992,"['ascension', 'lutheran', 'huntsville']",3,27,10,17,37.04
szekelyszallas,10989,"['zeke', 'lys', 'all']",3,14,4,10,28.57
protectiontestservice,10975,"['protection', 'test', 'service']",3,21,8,13,38.1
mantovaducale,10974,"['mantova', 'ducal']",2,13,6,7,46.15
eqs-biotech-circuit,10974,"['eqs', 'biotech', 'circuit']",3,19,7,12,36.84
mein-stadtstrand,10968,"['mein', 'stadt', 'strand']",3,16,4,12,25.0
heerajewellers,10962,"['era', 'jewellers']",2,14,6,8,42.86
delhitophotel,10962,"['delhi', 'top', 'hotel']",3,13,5,8,38.46
globalimporter,10956,"['global', 'importer']",2,14,5,9,35.71
miranda-world,10947,"['miranda', 'world']",2,13,4,9,30.77
gamecheatfree,10946,"['game', 'cheat', 'free']",3,13,6,7,46.15
notar-liessem,10938,"['not', 'lies', 'sem']",3,13,5,8,38.46
online-review,10932,"['online', 'review']",2,13,6,7,46.15
visualthesaurus,10932,"['visual', 'thesaurus']",2,15,7,8,46.67
createwebsite,10931,"['create', 'website']",2,13,6,7,46.15
simplesolution,10929,"['simple', 'solution']",2,14,6,8,42.86
sharethisstory,10924,"['share', 'this', 'story']",3,14,4,10,28.57
elsevierresource,10920,"['else', 'vier', 'resource']",3,16,8,8,50.0
mansumbabarat,10915,"['man', 'sumba', 'bar']",3,13,5,8,38.46
bizwebvietnam,10909,"['biz', 'web', 'vietnam']",3,13,5,8,38.46
chinaxinlizixun,10899,"['china', 'lizix']",2,15,6,9,40.0
livesex-exposed,10896,"['live', 'sex', 'exposed']",3,15,6,9,40.0
stoneparkcafe,10893,"['stone', 'park', 'cafe']",3,13,5,8,38.46
tenerifehotel,10875,"['tenerife', 'hotel']",2,13,6,7,46.15
villa-therese,10872,"['villa', 'therese']",2,13,5,8,38.46
hotel-in-denmark,10872,"['hotel', 'denmark']",2,16,5,11,31.25
sunaoni-syasei,10870,"['sun', 'sei']",2,14,7,7,50.0
indian-escort,10860,"['indian', 'escort']",2,13,5,8,38.46
weave-grid-dev,10851,"['weave', 'grid', 'dev']",3,14,5,9,35.71
chudosredstvo,10849,"['chu', 'dos', 'red']",3,13,4,9,30.77
zetabroadband,10845,"['zeta', 'broadband']",2,13,5,8,38.46
oldfemaleporn,10845,"['old', 'female', 'porn']",3,13,5,8,38.46
quantumdigital,10842,"['quantum', 'digital']",2,14,6,8,42.86
empresasbrasil,10835,"['emp', 'res', 'brasil']",3,14,5,9,35.71
starautismsupport,10831,"['star', 'autism', 'support']",3,17,6,11,35.29
planquadrat-c,10821,"['plan', 'quadra']",2,13,4,9,30.77
hotelinphuket,10820,"['hotel', 'phuket']",2,13,5,8,38.46
contentstackapps,10812,"['content', 'stack', 'apps']",3,16,4,12,25.0
cloudflareaccess,10806,"['cloud', 'flare', 'access']",3,16,6,10,37.5
ourdailybread,10804,"['our', 'daily', 'bread']",3,13,6,7,46.15
post-dispatch,10803,"['post', 'dispatch']",2,13,3,10,23.08
spendlittlemoney,10800,"['spend', 'little', 'money']",3,16,5,11,31.25
hotels-innewyork,10800,"['hotels', 'new', 'york']",3,16,5,11,31.25
impactpreview,10800,"['impact', 'preview']",2,13,5,8,38.46
pressure-point,10785,"['pressure', 'point']",2,14,5,9,35.71
ep-puehringer,10782,['ringer'],1,13,5,8,38.46
macygracehayes,10771,"['macy', 'grace', 'hayes']",3,14,5,9,35.71
fair-exchange,10770,"['fair', 'exchange']",2,13,5,8,38.46
inentorysource,10764,"['inen', 'tory', 'source']",3,14,6,8,42.86
paid-surveys-broker,10764,"['paid', 'surveys', 'broker']",3,19,6,13,31.58
crack-locator,10756,"['crack', 'locator']",2,13,4,9,30.77
getmassivetesto,10752,"['get', 'massive', 'tes']",3,15,6,9,40.0
gaslightmedia,10731,"['gaslight', 'media']",2,13,5,8,38.46
ultimateplaza,10728,"['ultimate', 'plaza']",2,13,6,7,46.15
mandymodel-exposed,10728,"['mandy', 'model', 'exposed']",3,18,6,12,33.33
serbianmodels,10728,"['serbian', 'models']",2,13,5,8,38.46
happybirthdaytoyou,10712,"['happy', 'birthday', 'you']",3,18,6,12,33.33
casinogoldshop,10707,"['casino', 'gold', 'shop']",3,14,5,9,35.71
aqua-delivery,10705,"['aqua', 'delivery']",2,13,6,7,46.15
airtechcompressor,10698,"['air', 'tech', 'compressor']",3,17,6,11,35.29
moscowcityhotels,10695,"['moscow', 'city', 'hotels']",3,16,5,11,31.25
northamptonmba,10686,"['northampton', 'mba']",2,14,4,10,28.57
shopifypreview,10683,"['shop', 'preview']",2,14,5,9,35.71
offerteonline2017,10680,"['offer', 'online', '2017']",3,17,6,11,35.29
heatlandpayroll,10668,"['heat', 'land', 'payroll']",3,15,5,10,33.33
studio-records,10664,"['studio', 'records']",2,14,5,9,35.71
liefernachweise,10662,"['liefer', 'nach']",2,15,7,8,46.67
brooklyntreeservice,10656,"['brooklyn', 'tree', 'service']",3,19,7,12,36.84
interactivedns,10646,"['interactive', 'dns']",2,14,5,9,35.71
motorsportreg,10639,"['motorsport', 'reg']",2,13,4,9,30.77
shoppersblaze,10636,"['shoppers', 'blaze']",2,13,4,9,30.77
educationtoday,10633,"['education', 'today']",2,14,7,7,50.0
fastboywebsites,10632,"['fast', 'boy', 'websites']",3,15,5,10,33.33
cityhotelsres,10632,"['city', 'hotels', 'res']",3,13,4,9,30.77
sidoihotellegian,10631,"['sido', 'hotel', 'legia']",3,16,8,8,50.0
womenshhighfashionheels,10620,"['women', 'high', 'fashion', 'heels']",4,23,8,15,34.78
silvergoldpricestoday,10620,"['silver', 'gold', 'prices', 'today']",4,21,7,14,33.33
filbet-casino,10611,"['fil', 'bet', 'casino']",3,13,5,8,38.46
fam-gundacker,10609,"['fam', 'gund', 'acker']",3,13,4,9,30.77
betsuperlucky,10602,"['bet', 'super', 'lucky']",3,13,4,9,30.77
elykinnovation,10602,"['ely', 'innovation']",2,14,6,8,42.86
usgovcloudapi,10601,"['usgov', 'cloud', 'api']",3,13,6,7,46.15
domainepardefaut,10594,"['maine', 'par', 'def', 'aut']",4,16,8,8,50.0
shandongtianmai,10594,"['shandong', 'tian', 'mai']",3,15,6,9,40.0
filbetsuperlucky,10587,"['fil', 'bet', 'super', 'lucky']",4,16,5,11,31.25
knowlesbrothers,10582,"['knowles', 'brothers']",2,15,4,11,26.67
lindagirl-exposed,10572,"['linda', 'girl', 'exposed']",3,17,6,11,35.29
buchhandlung-tippach,10560,"['buch', 'hand', 'lung', 'tipp', 'ach']",5,20,5,15,25.0
canadapostalcodes,10554,"['canada', 'postal', 'codes']",3,17,7,10,41.18
filsinger-verpackung,10551,"['fil', 'singer', 'ver', 'pac', 'kung']",5,20,6,14,30.0
inverseparadox,10550,"['inverse', 'paradox']",2,14,6,8,42.86
untivineyards,10545,"['unti', 'vineyards']",2,13,5,8,38.46
hotels-marrakesh,10545,"['hotels', 'marrakesh']",2,16,5,11,31.25
raptorcompliance,10542,"['raptor', 'compliance']",2,16,6,10,37.5
campusvirtualgitt,10534,"['campus', 'virtual']",2,17,6,11,35.29
musicfirstclassroom,10528,"['music', 'first', 'classroom']",3,19,6,13,31.58
mellow-yellow,10528,"['mellow', 'yellow']",2,13,4,9,30.77
safranrestaurant,10526,"['safran', 'restaurant']",2,16,6,10,37.5
lotsahelpinghands,10524,"['lots', 'helping', 'hands']",3,17,5,12,29.41
merchantpaymentprocessing,10523,"['merchant', 'payment', 'processing']",3,25,7,18,28.0
actito-campaign,10522,"['act', 'campaign']",2,15,6,9,40.0
ownernetworks,10521,"['owner', 'networks']",2,13,4,9,30.77
lojasonlinectt,10520,"['jason', 'line']",2,14,5,9,35.71
mailprosolutions,10514,"['mail', 'pro', 'solutions']",3,16,7,9,43.75
riskmanagementcenter,10512,"['risk', 'management', 'center']",3,20,7,13,35.0
trojanerboard,10507,"['trojan', 'board']",2,13,5,8,38.46
bomuldsfabriken,10501,"['omul', 'fab', 'riken']",3,15,5,10,33.33
hotels-compare-info,10500,"['hotels', 'compare', 'info']",3,19,7,12,36.84
yuchengyizhan,10500,['cheng'],1,13,4,9,30.77
restaurantwebx,10497,"['restaurant', 'web']",2,14,5,9,35.71
advertisingpeixun,10495,"['advertising', 'pei', 'xun']",3,17,7,10,41.18
zhongyangfish,10494,"['zhong', 'yang', 'fish']",3,13,3,10,23.08
radleymetzger,10494,"['radley', 'metzger']",2,13,4,9,30.77
beuth-hochschule,10491,['hochschule'],1,16,5,11,31.25
bailegongguoji,10488,"['baile', 'gong', 'guo']",3,14,7,7,50.0
hotels-rhodes,10485,"['hotels', 'rhodes']",2,13,4,9,30.77
betebetyeniadres,10479,"['bet', 'yeni', 'res']",3,16,7,9,43.75
versicherungsbuero-dortmund,10479,"['vers', 'iche', 'rungs', 'ero', 'dortmund']",5,27,9,18,33.33
trippen-schuhe,10476,"['trip', 'pen', 'schu']",3,14,4,10,28.57
gethiltonheadhotels,10473,"['get', 'hilton', 'head', 'hotels']",4,19,7,12,36.84
quintexonline,10467,"['quinte', 'online']",2,13,6,7,46.15
hotel-shenzhen,10467,"['hotel', 'shenzhen']",2,14,4,10,28.57
napleshotelitaly,10467,"['naples', 'hotel', 'italy']",3,16,6,10,37.5
trekcommunity,10466,"['trek', 'community']",2,13,4,9,30.77
aprenderemprenderdigital,10464,"['apr', 'ender', 'emp', 'render', 'digital']",5,24,9,15,37.5
payyourmdbill,10464,"['pay', 'your', 'bill']",3,13,4,9,30.77
pachinkorezero,10464,"['pachinko', 'zero']",2,14,6,8,42.86
ioexperttrades,10464,"['expert', 'trades']",2,14,6,8,42.86
top-hotels-in-jakarta,10461,"['top', 'hotels', 'jakarta']",3,21,7,14,33.33
smaulavirtual,10452,"['maula', 'virtual']",2,13,6,7,46.15
flash-nouveautes,10452,"['flash', 'nouveau', 'tes']",3,16,7,9,43.75
costadebarcelona,10449,"['costa', 'barcelona']",2,16,7,9,43.75
iangrahamcreative,10449,"['ian', 'graham', 'creative']",3,17,8,9,47.06
dashcommunications,10446,"['dash', 'communications']",2,18,7,11,38.89
tennis-wareouse,10440,"['tennis', 'ware', 'ouse']",3,15,7,8,46.67
sleepawareness,10435,"['sleep', 'awareness']",2,14,6,8,42.86
wwwjiujiuse99,10434,"['www', 'jiu', 'use']",3,13,5,8,38.46
split-dalmatia-hotels,10431,"['split', 'dalmatia', 'hotels']",3,21,7,14,33.33
diamondjourney,10431,"['diamond', 'journey']",2,14,6,8,42.86
kpmgcdd-fincrime,10426,"['kpm', 'gcd', 'fin', 'crime']",4,16,3,13,18.75
bestthingsforlife,10418,"['best', 'things', 'for', 'life']",4,17,5,12,29.41
gallowayclinic,10416,"['galloway', 'clinic']",2,14,5,9,35.71
northsmithfield,10416,"['north', 'smithfield']",2,15,4,11,26.67
mitsuyamathailand,10412,"['its', 'yama', 'thailand']",3,17,7,10,41.18
worldsbestlisting,10412,"['worlds', 'best', 'listing']",3,17,4,13,23.53
transformadora,10405,"['transform', 'dora']",2,14,5,9,35.71
xn--axels-kchen-studio-s6b,10404,"['axel', 'chen', 'studio']",3,26,6,20,23.08
kalastuskauppa,10404,"['kal', 'tusk']",2,14,6,8,42.86
jeepingsingles,10396,"['jeep', 'ing', 'singles']",3,14,5,9,35.71
johnsonwinery,10392,"['johnson', 'winery']",2,13,4,9,30.77
thailand-tourism,10383,"['thailand', 'tourism']",2,16,6,10,37.5
thatsmyideamarketing,10380,"['that', 'idea', 'marketing']",3,20,7,13,35.0
cantinelacigale,10372,"['cantin', 'aci', 'gale']",3,15,7,8,46.67
finalizarcompra,10368,"['final', 'izarc', 'pra']",3,15,6,9,40.0
tradervillagelive,10368,"['trader', 'village', 'live']",3,17,7,10,41.18
hotelsofoklahoma,10365,"['hotels', 'oklahoma']",2,16,7,9,43.75
go-budapest-hotels,10359,"['budapest', 'hotels']",2,18,6,12,33.33
reviews-hotels,10359,"['reviews', 'hotels']",2,14,5,9,35.71
fastapprovalpaydayloans,10358,"['fast', 'approval', 'payday', 'loans']",4,23,8,15,34.78
sergeyvinnichenko,10356,"['sergey', 'niche']",2,17,6,11,35.29
astutepayroll,10355,"['astute', 'payroll']",2,13,5,8,38.46
globalstreame,10350,"['global', 'stream']",2,13,5,8,38.46
creditcardforbadcredit,10344,"['credit', 'card', 'for', 'bad', 'credit']",5,22,7,15,31.82
hotels-costa-blanca,10343,"['hotels', 'costa', 'blanca']",3,19,6,13,31.58
clickhereformoreinfo,10338,"['click', 'here', 'for', 'more', 'info']",5,20,8,12,40.0
frisseverzameling,10335,"['sever', 'zam', 'eling']",3,17,6,11,35.29
basiliskpachinko,10329,"['basilisk', 'pachinko']",2,16,6,10,37.5
ecredithistory,10327,"['credit', 'history']",2,14,5,9,35.71
ixactcontactwebsites,10323,"['act', 'contact', 'websites']",3,20,7,13,35.0
thailandjewels,10311,"['thailand', 'jewels']",2,14,5,9,35.71
gclub-royalcasino,10309,"['club', 'royal', 'casino']",3,17,6,11,35.29
buscatucuadro,10308,"['bus', 'cat']",2,13,6,7,46.15
airwavebroadband,10308,"['air', 'wave', 'broadband']",3,16,7,9,43.75
mycyprushotels,10308,"['cyprus', 'hotels']",2,14,3,11,21.43
rezervuj-online,10305,"['rez', 'online']",2,15,6,9,40.0
fuzhoushangyi,10290,"['fuzhou', 'shang']",2,13,5,8,38.46
mariagharaibeh,10290,"['maria', 'ghara', 'beh']",3,14,7,7,50.0
directorfocus,10289,"['director', 'focus']",2,13,5,8,38.46
makingmoneyonlineis,10288,"['making', 'money', 'online']",3,19,8,11,42.11
wholefoodsmarket,10283,"['whole', 'foods', 'market']",3,16,6,10,37.5
theanschutzfoundation,10276,"['the', 'anschutz', 'foundation']",3,21,8,13,38.1
pagespro-orange,10275,"['pages', 'pro', 'orange']",3,15,6,9,40.0
exploreschomes,10275,"['explores', 'homes']",2,14,5,9,35.71
strongestforce,10269,"['strongest', 'force']",2,14,4,10,28.57
slowfoodthailand,10265,"['slow', 'food', 'thailand']",3,16,6,10,37.5
tritektelecom,10265,"['trite', 'telecom']",2,13,5,8,38.46
overzichtdirect,10254,"['over', 'direct']",2,15,5,10,33.33
qingdaohealth,10253,"['qing', 'dao', 'health']",3,13,5,8,38.46
bureaumerkwaardig,10251,"['bureau', 'mer', 'waar', 'dig']",4,17,8,9,47.06
xn--axels-kchenhaus-5vb,10248,"['axel', 'chen', 'haus']",3,23,5,18,21.74
brain-booster,10242,"['brain', 'booster']",2,13,5,8,38.46
soyoungthailand,10239,"['young', 'thailand']",2,15,6,9,40.0
thaiboathouse,10231,"['thai', 'boat', 'house']",3,13,7,6,53.85
thailandtortan,10230,"['thailand', 'tort']",2,14,5,9,35.71
nachthailandauswandern,10230,"['nach', 'thailand', 'wander']",3,22,8,14,36.36
thegioidulichthailand,10227,"['the', 'oid', 'lich', 'thailand']",4,21,9,12,42.86
motanalottery,10227,"['mot', 'lottery']",2,13,5,8,38.46
allsalzburghotels,10227,"['all', 'salzburg', 'hotels']",3,17,5,12,29.41
thaionlinetravel,10223,"['thai', 'online', 'travel']",3,16,7,9,43.75
mtcdevserver2,10217,"['mtc', 'dev', 'server']",3,13,3,10,23.08
hoi-an-hotels,10212,"['hoi', 'hotels']",2,13,5,8,38.46
bestjourneyhotels,10209,"['best', 'journey', 'hotels']",3,17,6,11,35.29
xinkaichuanqifabu,10204,"['kai', 'chuan', 'qif', 'abu']",4,17,8,9,47.06
screenconnect,10198,"['screen', 'connect']",2,13,4,9,30.77
oushiyimulayou,10197,"['shi', 'mula', 'you']",3,14,8,6,57.14
noord-holland-hotels,10191,"['noord', 'holland', 'hotels']",3,20,6,14,30.0
sessoaltelefono,10190,"['esso', 'telef', 'ono']",3,15,7,8,46.67
federationmondiale,10188,"['federation', 'mondiale']",2,18,9,9,50.0
intrexxperience,10188,"['tre', 'peri']",2,15,6,9,40.0
xn--dijiretim-37a56b,10188,"['diji', 'tim']",2,20,5,15,25.0
contacto-local,10185,"['contact', 'local']",2,14,5,9,35.71
creativriderz,10183,"['eat', 'rider']",2,13,5,8,38.46
destin-florida-hotels,10179,"['destin', 'florida', 'hotels']",3,21,7,14,33.33
health-top100,10178,"['health', 'top', '100']",3,13,3,10,23.08
cortex-tickets,10177,"['cortex', 'tickets']",2,14,4,10,28.57
bridgepatientportal,10176,"['bridge', 'patient', 'portal']",3,19,7,12,36.84
la-boite-immo,10174,"['boi', 'mmo']",2,13,6,7,46.15
phonoscopecable,10172,"['ono', 'scope', 'cable']",3,15,6,9,40.0
ringcustomerservices,10170,"['ring', 'customer', 'services']",3,20,7,13,35.0
trinity-events,10168,"['trinity', 'events']",2,14,4,10,28.57
joesshoeemporium,10167,"['joe', 'shoe', 'emporium']",3,16,8,8,50.0
steroids-thailand,10166,"['steroids', 'thailand']",2,17,6,11,35.29
websitedetective,10165,"['website', 'detective']",2,16,7,9,43.75
all-hotels-venice,10164,"['all', 'hotels', 'venice']",3,17,6,11,35.29
countryclubshopping,10164,"['country', 'club', 'shopping']",3,19,5,14,26.32
fantasticdoctor,10162,"['fantastic', 'doctor']",2,15,5,10,33.33
hotelsresortsworld,10158,"['hotels', 'resorts', 'world']",3,18,5,13,27.78
treasuredidea,10152,"['treasured', 'idea']",2,13,7,6,53.85
mobilbahisgirisi,10151,"['mobil', 'bah', 'gir']",3,16,7,9,43.75
stjohnsblackstock,10143,"['johns', 'black', 'stock']",3,17,3,14,17.65
szambabetonowe,10132,"['zam', 'babe', 'nowe']",3,14,6,8,42.86
mukherjeeudyog,10132,"['muk', 'her', 'eudy']",3,14,6,8,42.86
northyorkshirehotels,10126,"['north', 'yorkshire', 'hotels']",3,20,6,14,30.0
world-tophotels,10125,"['world', 'top', 'hotels']",3,15,4,11,26.67
articlesmarket,10122,"['articles', 'market']",2,14,5,9,35.71
idrivecompute,10122,"['drive', 'compute']",2,13,6,7,46.15
hotel-in-berlin,10120,"['hotel', 'berlin']",2,15,5,10,33.33
reirobotsites,10119,"['rei', 'robot', 'sites']",3,13,6,7,46.15
thaisuperstars,10116,"['thai', 'superstars']",2,14,5,9,35.71
citymattresses,10104,"['city', 'mattresses']",2,14,4,10,28.57
providentdecor,10104,"['provident', 'decor']",2,14,5,9,35.71
digicelpanama,10104,"['dig', 'ice', 'panama']",3,13,6,7,46.15
superofferteitaliane,10103,"['super', 'offer', 'italian']",3,20,10,10,50.0
prepaid-webspace,10101,"['prepaid', 'web', 'space']",3,16,6,10,37.5
avalon-invest,10099,"['avalon', 'invest']",2,13,5,8,38.46
tbsbetthailand,10094,"['tbs', 'bet', 'thailand']",3,14,4,10,28.57
2019sexvideos,10092,"['2019', 'sex', 'videos']",3,13,4,9,30.77
schule-rehamittelberg,10092,"['schule', 'reh', 'mitte', 'lberg']",4,21,7,14,33.33
mes-petites-frites,10084,"['mes', 'petites', 'rites']",3,18,6,12,33.33
hovawart-vom-waldhof,10080,"['ova', 'wart', 'vom', 'waldhof']",4,20,6,14,30.0
nycpayordispute,10080,"['nyc', 'pay', 'dispute']",3,15,5,10,33.33
vps-default-host,10079,"['default', 'host']",2,16,4,12,25.0
opus-techsolutions,10078,"['opus', 'tech', 'solutions']",3,18,7,11,38.89
zellmer-maschinen,10077,"['ell', 'mer', 'mas', 'chin']",4,17,5,12,29.41
incontrilocali,10071,"['con', 'tri', 'local']",3,14,6,8,42.86
courtinginfluence,10070,"['courting', 'influence']",2,17,7,10,41.18
deepsouthequipment,10070,"['deep', 'south', 'equipment']",3,18,8,10,44.44
institute-regenerativemedicine,10068,"['institute', 'regenerative', 'medicine']",3,30,14,16,46.67
rc-car-classics,10068,"['car', 'classics']",2,15,3,12,20.0
myguestaccount,10067,"['guest', 'account']",2,14,5,9,35.71
mostbeautyboy,10065,"['most', 'beauty', 'boy']",3,13,5,8,38.46
neurotechforum,10064,"['neuro', 'tech', 'forum']",3,14,6,8,42.86
toyota-dealerwebsites,10064,"['toyota', 'dealer', 'websites']",3,21,9,12,42.86
bkg-neuruppin,10059,['neuruppin'],1,13,4,9,30.77
managebuilding,10057,"['manage', 'building']",2,14,6,8,42.86
bobcatoffresno,10056,"['bobcat', 'fresno']",2,14,5,9,35.71
radioadvertisingworld,10055,"['radio', 'advertising', 'world']",3,21,8,13,38.1
tenerife-all-hotels,10053,"['tenerife', 'all', 'hotels']",3,19,7,12,36.84
hotels-colorado,10050,"['hotels', 'colorado']",2,15,6,9,40.0
tulsaworldnews,10044,"['tulsa', 'world', 'news']",3,14,4,10,28.57
madrid-hoteles,10044,"['madrid', 'hotel']",2,14,5,9,35.71
propertycapsule,10043,"['property', 'capsule']",2,15,5,10,33.33
dkfz-heidelberg,10040,['heidelberg'],1,15,4,11,26.67
fiber-operator,10038,"['fiber', 'operator']",2,14,6,8,42.86
shopatoxonpress,10035,"['shop', 'oxon', 'press']",3,15,5,10,33.33
nldappraisals,10035,"['nld', 'appraisals']",2,13,4,9,30.77
riminihotelsreservations,10029,"['rimini', 'hotels', 'reservations']",3,24,10,14,41.67
martincolesfitness,10027,"['martin', 'coles', 'fitness']",3,18,6,12,33.33
obchodny-register,10023,"['chod', 'register']",2,17,5,12,29.41
girlsyouareloved,10020,"['girls', 'you', 'are', 'loved']",4,16,7,9,43.75
myhome-server,10017,"['home', 'server']",2,13,4,9,30.77
schmitz-beggendorf,10008,"['schmitz', 'eggendorf']",2,18,4,14,22.22
gymleadmachine,10005,"['gym', 'lead', 'machine']",3,14,5,9,35.71
diagnoseonline,10005,"['diagnose', 'online']",2,14,7,7,50.0
mcmastermedia,10005,"['mcmaster', 'media']",2,13,5,8,38.46
